エネルギーの使用の合理化に関する法律の規定に基づく立入検査をする職員の携帯する身分を示す証明書の様式を定める省令	省エネ法立入検査職員の身分証明書の様式を定める省令																		
外務省設置法	中央省庁等改革関連法																		
エネルギーの使用の合理化等に関する法律の規定に基づく立入検査をする職員の携帯する身分を示す証明書の様式を定める省令	省エネ法立入検査職員の身分証明書の様式を定める省令																		
オウム真理教犯罪被害者等を救済するための給付金の支給に関する法律	オウム真理教犯罪被害者救済法																		
お茶の振興に関する法律	お茶振興法																		
お年玉付郵便葉書等に関する法律	お年玉法																		
お年玉付郵便葉書等に関する法律施行規則	お年玉法施行規則																		
お年玉付郵便葉書等に関する法律施行令	お年玉法施行令																		
がん対策基本法	がん対策法																		
がん登録等の推進に関する法律	がん登録推進法																		
がん登録等の推進に関する法律施行規則	がん登録推進法施行規則																		
がん登録等の推進に関する法律施行令	がん登録推進法施行令																		
がん登録等の推進に関する法律第十五条第二項の審議会等を定める政令	がん登録推進法第十五条第二項の審議会等を定める政令																		
ゴルフ場等に係る会員契約の適正化に関する法律	ゴルフ場会員適正化法																		
確定拠出年金法	日本版４０１ｋ法	ＤＣ法																	
ゴルフ場等に係る会員契約の適正化に関する法律施行規則	ゴルフ場会員適正化法施行規則																		
ゴルフ場等に係る会員契約の適正化に関する法律施行令	ゴルフ場会員適正化法施行令																		
コンテンツの創造、保護及び活用の促進に関する法律	コンテンツ促進法																		
ドミニカ移住者に対する特別一時金の支給等に関する法律	ドミニカ移住者特別一時金支給法																		
ドミニカ移住者に対する特別一時金の支給等に関する法律施行規則	ドミニカ移住者特別一時金支給法施行規則																		
確定拠出年金法施行令	日本版４０１ｋ法施行令	ＤＣ法施行令																	
学校教育法	学教法																		
ハンセン病問題の解決の促進に関する法律	ハンセン病問題基本法	ハンセン病基本法	ハンセン病問題解決促進法																
学校教育法施行規則	学教法施行規則																		
学校教育法施行令	学教法施行令																		
いじめ防止対策推進法	いじめ対策法																		
ハンセン病問題の解決の促進に関する法律施行規則	ハンセン病問題基本法施行規則	ハンセン病基本法施行規則	ハンセン病問題解決促進法施行規則																
ハンセン病問題の解決の促進に関する法律第十九条に規定する援護に関する政令	ハンセン病問題基本法第十九条に規定する援護に関する政令	ハンセン病基本法第十九条に規定する援護に関する政令	ハンセン病問題解決促進法第十九条に規定する援護に関する政令																
フロン類の使用の合理化及び管理の適正化に関する法律に係る民間事業者等が行う書面の保存等における情報通信の技術の利用に関する法律施行規則	フロン排出抑制法																		
安全な血液製剤の安定供給の確保等に関する法律	血液法																		
移植に用いる造血幹細胞の適切な提供の推進に関する法律	造血幹細胞提供推進法																		
医学及び歯学の教育のための献体に関する法律	献体法																		
医薬品、医療機器等の品質、有効性及び安全性の確保等に関する法律	薬事法	医薬品医療機器等法																	
医薬品、医療機器等の品質、有効性及び安全性の確保等に関する法律に基づく医薬品及び再生医療等製品の使用の禁止に関する規定の適用を受けない場合を定める省令	薬事法に基づく医薬品及び再生医療等製品の使用の禁止に関する規定の適用を受けない場合を定める省令	医薬品医療機器等法に基づく医薬品及び再生医療等製品の使用の禁止に関する規定の適用を受けない場合を定める省令																	
医薬品、医療機器等の品質、有効性及び安全性の確保等に関する法律関係手数料規則	薬事法関係手数料規則	医薬品医療機器等法関係手数料規則																	
医薬品、医療機器等の品質、有効性及び安全性の確保等に関する法律関係手数料令	薬事法関係手数料令	医薬品医療機器等法関係手数料令																	
医薬品、医療機器等の品質、有効性及び安全性の確保等に関する法律施行規則	薬事法施行規則	医薬品医療機器等法施行規則																	
会社分割に伴う労働契約の承継等に関する法律	労働契約承継法																		
会社分割に伴う労働契約の承継等に関する法律施行規則	労働契約承継法施行規則																		
海洋汚染等及び海上災害の防止に関する法律	海防法																		
ホームレスの自立の支援等に関する特別措置法	ホームレス自立支援法	ホームレス自立支援特別措置法																	
医薬品、医療機器等の品質、有効性及び安全性の確保等に関する法律施行規則第十二条第一項に規定する試験検査機関の登録に関する省令	薬事法施行規則第十二条第一項に規定する試験検査機関の登録に関する省令	医薬品医療機器等法施行規則第十二条第一項に規定する試験検査機関の登録に関する省令																	
医薬品、医療機器等の品質、有効性及び安全性の確保等に関する法律施行規則第百十四条の四十九第一項第三号に規定する講習等を行う者の登録等に関する省令	薬事法施行規則第百十四条の四十九第一項第三号に規定する講習等を行う者の登録等に関する省令	医薬品医療機器等法施行規則第百十四条の四十九第一項第三号に規定する講習等を行う者の登録等に関する省令																	
医薬品、医療機器等の品質、有効性及び安全性の確保等に関する法律施行令	薬事法施行令	医薬品医療機器等法施行令																	
医薬品、医療機器等の品質、有効性及び安全性の確保等に関する法律第十四条の三第一項の医薬品等を定める政令	薬事法第十四条の三第一項の医薬品等を定める政令	医薬品医療機器等法第十四条の三第一項の医薬品等を定める政令																	
医薬品、医療機器等の品質、有効性及び安全性の確保等に関する法律第二十三条の二の五第七項第一号に規定する医療機器又は体外診断用医薬品の区分を定める省令	薬事法第二十三条の二の五第七項第一号に規定する医療機器又は体外診断用医薬品の区分を定める省令	医薬品医療機器等法第二十三条の二の五第七項第一号に規定する医療機器又は体外診断用医薬品の区分を定める省令																	
学校教育法第八十九条の規定を適用しない者を定める省令	学教法第八十九条の規定を適用しない者を定める省令																		
金融商品取引法等に基づく課徴金等の納付手続の特例に関する省令	金商法等に基づく課徴金等の納付手続の特例に関する省令																		
医薬品、医療機器等の品質、有効性及び安全性の確保等に関する法律第二条第十五項に規定する指定薬物及び同法第七十六条の四に規定する医療等の用途を定める省令	薬事法第二条第十五項に規定する指定薬物及び同法第七十六条の四に規定する医療等の用途を定める省令	医薬品医療機器等法第二条第十五項に規定する指定薬物及び同法第七十六条の四に規定する医療等の用途を定める省令																	
一般社団法人及び一般財団法人に関する法律	一般法人法	一般社団・財団法	一般社団・財団法人法																
一般職の職員の給与に関する法律	一般職給与法																		
一般職の職員の給与に関する法律等の一部を改正する法律の一部の施行に伴う国家公務員宿舎法施行規則第六条第二項ただし書に規定する宿舎に係る経過措置に関する省令	一般職給与法等の一部を改正する法律の一部の施行に伴う国家公務員宿舎法施行規則第六条第二項ただし書に規定する宿舎に係る経過措置に関する省令																		
一般職の職員の給与に関する法律等の一部を改正する法律の施行に伴う関係政令の整備及び経過措置に関する政令　抄	一般職給与法等の一部を改正する法律の施行に伴う関係政令の整備及び経過措置に関する政令　抄																		
一般職の任期付研究員の採用、給与及び勤務時間の特例に関する法律	任期付研究員法																		
一般職の任期付職員の採用及び給与の特例に関する法律	任期付職員法																		
引揚者等に対する特別交付金の支給に関する法律	在外財産補償法																		
雨水の利用の推進に関する法律	雨水利用推進法																		
雨水の利用の推進に関する法律第二条第二項の法人を定める政令	雨水利用推進法第二条第二項の法人を定める政令																		
映画の盗撮の防止に関する法律	映画盗撮防止法																		
液化石油ガスの保安の確保及び取引の適正化に関する法律	液石法	ＬＰＧ法	ＬＰガス法	液化石油ガス法															
奄美群島振興開発特別措置法	奄美法																		
沖縄の復帰に伴う鉱業等に係る土地利用の調整手続等に関する法律の適用の特別措置に関する政令	沖縄の復帰に伴う土地利用調整法の適用の特別措置に関する政令																		
沖縄県における駐留軍用地跡地の有効かつ適切な利用の推進に関する特別措置法	跡地利用特措法																		
沖縄振興特別措置法	沖振法	沖縄振興特措法																	
屋外広告物法	広告法																		
屋外広告物法施行規則	広告法施行規則																		
下級裁判所の設立及び管轄区域に関する法律	下級裁設立管轄区域法																		
下請代金支払遅延等防止法	下請法																		
加工原料乳生産者補給金等暫定措置法	加工原料乳不足払い法																		
家畜伝染病予防法	家伝法																		
家畜伝染病予防法施行規則	家伝法施行規則																		
家畜伝染病予防法施行令	家伝法施行令																		
果樹農業振興特別措置法	果振法																		
火炎びんの使用等の処罰に関する法律	火炎びん処罰法																		
火薬類取締法	火取法																		
火薬類取締法の規定に基づく意見の聴取の手続に関する規則	火取法の規定に基づく意見の聴取の手続に関する規則																		
過疎地域自立促進特別措置法	過疎法	自立促進法																	
過労死等防止対策推進法	過労死防止法																		
会社更生法	会更法																		
外国の地方公共団体の機関等に派遣される一般職の地方公務員の処遇等に関する法律	地方公務員派遣法																		
外国為替及び外国貿易法	外為法	外国為替法																	
外国為替令	外為令																		
外国裁判所ノ嘱託ニ因ル共助法	外嘱法																		
外国人漁業の規制に関する法律	外国人漁業規制法	外規法																	
外国人漁業の規制に関する法律施行規則	外国人漁業規制法施行規則	外規法施行規則																	
外国人漁業の規制に関する法律施行令	外国人漁業規制法施行令	外規法施行令																	
外国倒産処理手続の承認援助に関する法律	承認援助法																		
外国等による本邦外航船舶運航事業者に対する不利益な取扱いに対する特別措置に関する法律	国旗差別対抗法																		
外国等による本邦外航船舶運航事業者に対する不利益な取扱いに対する特別措置に関する法律施行規則	国旗差別対抗法施行規則																		
外国等に対する我が国の民事裁判権に関する法律	対外国民事裁判権法	民事裁判権法																	
学校教育法第百十条第二項に規定する基準を適用するに際して必要な細目を定める省令	学教法第百十条第二項に規定する基準を適用するに際して必要な細目を定める省令																		
割賦販売法	割販法																		
割賦販売法施行規則	割販法施行規則																		
割賦販売法施行令	割販法施行令																		
株式の消却の手続に関する商法の特例に関する法律第四条に規定する取引に関する命令	株式消却特例法第四条に規定する取引に関する命令																		
株式会社商工組合中央金庫法	商工中金法																		
株式会社商工組合中央金庫法及び中小企業信用保険法の一部を改正する法律の一部の施行期日を定める政令	商工中金法及び中小企業信用保険法の一部を改正する法律の一部の施行期日を定める政令																		
株式会社商工組合中央金庫法施行令	商工中金法施行令																		
幹線道路の沿道の整備に関する法律	沿道整備法																		
幹線道路の沿道の整備に関する法律施行規則	沿道整備法施行規則																		
幹線道路の沿道の整備に関する法律施行令	沿道整備法施行令																		
環境影響評価法施行令別表第三の十の項の第三欄に規定する値を定める省令	環境アセス法施行令別表第三の十の項の第三欄に規定する値を定める省令，環境アセスメント法施行令別表第三の十の項の第三欄に規定する値を定める省令																		
環境省関係構造改革特別区域法施行規則	環境省関係特区法施行規則																		
環境省関係国家戦略特別区域法第二十六条に規定する政令等規制事業に係る省令の特例に関する措置を定める命令	環境省関係特区法第二十六条に規定する政令等規制事業に係る省令の特例に関する措置を定める命令																		
環境省設置法	中央省庁等改革関連法																		
簡素で効率的な政府を実現するための行政改革の推進に関する法律	行革推進法	行政改革推進法																	
簡素で効率的な政府を実現するための行政改革の推進に関する法律第五十三条第一項の法人並びに同法第五十四条第一項の特殊法人及び認可法人を定める政令	行革推進法	行政改革推進法第五十三条第一項の法人並びに同法第五十四条第一項の特殊法人及び認可法人を定める政令																	
関西文化学術研究都市建設促進法	関西学研法																		
関西文化学術研究都市建設促進法第十一条の地方公共団体等を定める省令	関西学研法第十一条の地方公共団体等を定める省令																		
揮発油等の品質の確保等に関する法律	品確法																		
揮発油等の品質の確保等に関する法律施行規則	品確法施行規則																		
揮発油等の品質の確保等に関する法律施行令	品確法施行令																		
義務教育諸学校における教育の政治的中立の確保に関する臨時措置法	中確法	義務教育中立法																	
義務教育諸学校における教育の政治的中立の確保に関する臨時措置法第五条の請求の手続を定める政令	中確法第五条の請求の手続を定める政令	義務教育中立法第五条の請求の手続を定める政令																	
義務教育諸学校の教科用図書の無償措置に関する法律	教科書無償措置法																		
義務教育諸学校の教科用図書の無償措置に関する法律施行規則	教科書無償措置法施行規則																		
義務教育諸学校の教科用図書の無償措置に関する法律施行令	教科書無償措置法施行令																		
義務教育諸学校等の施設費の国庫負担等に関する法律	施設費負担法																		
義務教育諸学校等の施設費の国庫負担等に関する法律施行規則	施設費負担法施行規則																		
義務教育諸学校等の施設費の国庫負担等に関する法律施行令	施設費負担法施行令																		
救急医療用ヘリコプターを用いた救急医療の確保に関する特別措置法	ドクターヘリ法	ドクターヘリ特別措置法																	
救急医療用ヘリコプターを用いた救急医療の確保に関する特別措置法に規定する助成金交付事業に係る登録に関する省令	ドクターヘリ法に規定する助成金交付事業に係る登録に関する省令	ドクターヘリ特別措置法に規定する助成金交付事業に係る登録に関する省令																	
旧軍人等の遺族に対する恩給等の特例に関する法律	恩給特例法																		
旧軍人等の遺族に対する恩給等の特例に関する法律に基づく事実調査に関する省令	恩給特例法に基づく事実調査に関する省令																		
金融商品取引法第六章の二の規定による課徴金に関する内閣府令	金商法第六章の二の規定による課徴金に関する内閣府令																		
旧軍人等の遺族に対する恩給等の特例に関する法律の規定により給すべき扶助料又は改定すべき扶助料の請求手続に関する省令	恩給特例法の規定により給すべき扶助料又は改定すべき扶助料の請求手続に関する省令																		
旧軍人等の遺族に対する恩給等の特例に関する法律施行令	恩給特例法施行令																		
漁業経営の改善及び再建整備に関する特別措置法	漁特法																		
漁業経営の改善及び再建整備に関する特別措置法施行規則	漁特法施行規則																		
漁業経営の改善及び再建整備に関する特別措置法施行令	漁特法施行令																		
漁業経営の改善及び再建整備に関する特別措置法第十三条第一項の職業転換給付金に関する政令	漁特法第十三条第一項の職業転換給付金に関する政令																		
漁業経営の改善及び再建整備に関する特別措置法第十三条第一項の職業転換給付金の支給基準に関する省令	漁特法第十三条第一項の職業転換給付金の支給基準に関する省令																		
共同溝の整備等に関する特別措置法	共同溝法																		
共同溝の整備等に関する特別措置法施行規則	共同溝法施行規則																		
共同溝の整備等に関する特別措置法施行令	共同溝法施行令																		
協同組織金融機関の優先出資に関する法律	優先出資法																		
協同組織金融機関の優先出資に関する法律に係る民間事業者等が行う書面の保存等における情報通信の技術の利用に関する命令	優先出資法に係る民間事業者等が行う書面の保存等における情報通信の技術の利用に関する命令																		
協同組織金融機関の優先出資に関する法律施行令	優先出資法施行令																		
教育基本法	教基法																		
教育公務員特例法	教特法																		
教育公務員特例法施行令	教特法施行令																		
教育公務員特例法第三十一条及び第三十五条の規定に基づく国立教育政策研究所の長等の選考の手続及び任期等を定める手続に関する省令	教特法第三十一条及び第三十五条の規定に基づく国立教育政策研究所の長等の選考の手続及び任期等を定める手続に関する省令																		
教育公務員特例法第二十二条の四第二項第五号の教員研修計画に定める事項及び第二十二条の五第二項第二号の文部科学省令で定める者を定める省令	教特法第二十二条の四第二項第五号の教員研修計画に定める事項及び第二十二条の五第二項第二号の文部科学省令で定める者を定める省令																		
教育公務員特例法附則第二条の規定の適用を受ける公立学校職員等について学校看護婦としての在職を準教育職員としての在職とみなすことに関する法律	教特法附則第二条の規定の適用を受ける公立学校職員等について学校看護婦としての在職を準教育職員としての在職とみなすことに関する法律																		
教育職員免許法	教育免許法																		
教育職員免許法施行規則	教育免許法施行規則																		
教育職員免許法施行法　抄	教育免許法施行法　抄																		
教育職員免許法施行法施行規則	教育免許法施行法施行規則																		
教育職員免許法施行令	教育免許法施行令																		
勤労者財産形成促進法	財形法																		
勤労者財産形成促進法施行規則	財形法施行規則																		
勤労者財産形成促進法施行令	財形法施行令第三十六条第二項及び第三項の基準を定める省令																		
勤労者財産形成促進法施行令第三十六条第二項及び第三項の基準を定める省令	財形法施行令第三十六条第二項及び第三項の基準を定める省令																		
勤労者財産形成促進法施行令附則第五項の事項及び基準を定める省令	財形法施行令附則第五項の事項及び基準を定める省令																		
特定多目的ダム法施行令	ダム法施行令																		
勤労者財産形成促進法施行令附則第八項の住宅を定める省令	財形法施行令附則第八項の住宅を定める省令																		
金融システム改革のための関係法律の整備等に関する法律附則第四十三条第一項に規定する資金の貸付けを定める命令	金融システム改革法																		
金融機関の合併及び転換に関する法律	合転法	合併転換法																	
金融機関の合併及び転換に関する法律施行令	合転法	合併転換法施行令																	
金融業者の貸付業務のための社債の発行等に関する法律	金融業者社債発行法	ノンバンク社債法																	
金融業者の貸付業務のための社債の発行等に関する法律施行規則	金融業者社債発行法施行規則	ノンバンク社債法施行規則																	
金融業者の貸付業務のための社債の発行等に関する法律施行令	金融業者社債発行法施行令	ノンバンク社債法施行令																	
金融商品取引法の一部を改正する法律附則第四条の政令で定める日を定める政令	金商法の一部を改正する法律附則第四条の政令で定める日を定める政令																		
金融商品取引法の審判手続等における参考人及び鑑定人の旅費及び手当に関する政令	金商法の審判手続等における参考人及び鑑定人の旅費及び手当に関する政令																		
金融商品取引法第五章の五の規定による指定紛争解決機関に関する内閣府令	金商法第五章の五の規定による指定紛争解決機関に関する内閣府令																		
津波対策の推進に関する法律	津波対策推進法																		
金融商品取引法等の一部を改正する法律附則第三条第五項の規定による権限の委任に関する政令	金商法等の一部を改正する法律附則第三条第五項の規定による権限の委任に関する政令																		
金融商品取引法令に違反する行為を行った者の氏名等の公表に関する内閣府令	金商法令に違反する行為を行った者の氏名等の公表に関する内閣府令																		
空家等対策の推進に関する特別措置法	空家特措法																		
空家等対策の推進に関する特別措置法施行規則	空家特措法施行規則																		
刑事収容施設及び被収容者等の処遇に関する法律	刑事施設法	刑事収容施設法																	
刑事訴訟法	刑訴法																		
刑事訴訟法の規定による司法警察職員として職務を行う皇宮護衛官に関する規則	刑訴法の規定による司法警察職員として職務を行う皇宮護衛官に関する規則																		
刑事訴訟法施行法　抄	刑訴法施行法　抄																		
刑事訴訟法第三十六条の二の資産及び同法第三十六条の三第一項の基準額を定める政令	刑訴法第三十六条の二の資産及び同法第三十六条の三第一項の基準額を定める政令																		
刑事訴訟法第百九十四条に基く懲戒処分に関する法律	刑訴法第百九十四条に基く懲戒処分に関する法律																		
刑事訴訟法第百八十九条第一項および第百九十九条第二項の規定に基づく司法警察員等の指定に関する規則	刑訴法第百八十九条第一項および第百九十九条第二項の規定に基づく司法警察員等の指定に関する規則																		
経済産業省・財務省・内閣府関係株式会社商工組合中央金庫法施行規則	経済産業省・財務省・内閣府関係株式会社商工中金法施行規則																		
経済産業省・財務省関係株式会社商工組合中央金庫法施行規則	経済産業省・財務省関係株式会社商工中金法施行規則																		
経済産業省関係構造改革特別区域法施行規則	経済産業省関係特区法施行規則																		
経済産業省関係構造改革特別区域法第二条第三項に規定する省令の特例に関する措置及びその適用を受ける特定事業を定める省令	経済産業省関係特区法に規定する特例措置及び特定事業を定める省令																		
経済産業省設置法	中央省庁等改革関連法																		
警察官職務執行法	警職法																		
警察等が取り扱う死体の死因又は身元の調査等に関する法律	死因身元調査法																		
警察等が取り扱う死体の死因又は身元の調査等に関する法律施行令	死因身元調査法施行令																		
劇場、音楽堂等の活性化に関する法律	劇場法																		
激甚災害に対処するための特別の財政援助等に関する法律	激甚法	激甚災害法																	
健康保険の被保険者に係る健康保険法の適用及び厚生年金保険の適用事業所に係る厚生年金保険法の適用に関する政令	健康保険の被保険者に係る健保法の適用及び厚生年金保険の適用事業所に係る厚生年金法の適用に関する政令																		
健康保険法	健保法																		
健康保険法施行規則	健保法施行規則																		
健康保険法施行令	健保法施行令																		
金融商品取引法	金商法	証取法																	
健康保険法等の一部を改正する法律の施行に伴う経過措置に関する政令	健保法等の一部を改正する法律の施行に伴う経過措置に関する政令																		
健康保険法等の一部を改正する法律の施行に伴う経過措置に関する政令	健保法等の一部を改正する法律の施行に伴う経過措置に関する政令																		
建設労働者の雇用の改善等に関する法律	建設労働者雇用改善法																		
建設労働者の雇用の改善等に関する法律施行規則	建設労働者雇用改善法施行規則																		
建設労働者の雇用の改善等に関する法律施行令	建設労働者雇用改善法施行令																		
建築基準法	建基法																		
建築基準法に基づく指定建築基準適合判定資格者検定機関等に関する省令	建基法に基づく指定建築基準適合判定資格者検定機関等に関する省令																		
建築基準法施行規則	建基法施行規則																		
建築基準法施行令	建基法施行令																		
建築基準法第四条第一項の人口二十五万以上の市を指定する政令	建基法第四条第一項の人口二十五万以上の市を指定する政令																		
建築物のエネルギー消費性能の向上に関する法律	建築物省エネ法																		
建築物のエネルギー消費性能の向上に関する法律施行規則	建築物省エネ法施行規則																		
建築物のエネルギー消費性能の向上に関する法律施行令	建築物省エネ法施行令																		
建築物の耐震改修の促進に関する法律	耐震改修促進法																		
通貨の単位及び貨幣の発行等に関する法律	貨幣法																		
建築物の耐震改修の促進に関する法律施行規則	耐震改修促進法施行規則																		
建築物の耐震改修の促進に関する法律施行令	耐震改修促進法施行令																		
建築物用地下水の採取の規制に関する法律	ビル用水法																		
建築物用地下水の採取の規制に関する法律施行規則	ビル用水法施行規則																		
建築物用地下水の採取の規制に関する法律施行令	ビル用水法施行令																		
検察官の俸給等に関する法律	検察官俸給法																		
検察審査会法	検審法																		
検察審査会法施行令	検審法施行令																		
原子力災害対策特別措置法	原災法	原子力災害特措法																	
原子力災害対策特別措置法に基づき原子力事業者が作成すべき原子力事業者防災業務計画等に関する命令	原災法に基づき原子力事業者が作成すべき原子力事業者防災業務計画等に関する命令	原子力災害特措法に基づき原子力事業者が作成すべき原子力事業者防災業務計画等に関する命令																	
原子力災害対策特別措置法に基づき原子力防災管理者が通報すべき事業所外運搬に係る事象の通報手続等に関する省令	原災法に基づき原子力防災管理者が通報すべき事業所外運搬に係る事象の通報手続等に関する省令	原子力災害特措法に基づき原子力防災管理者が通報すべき事業所外運搬に係る事象の通報手続等に関する省令																	
原子力災害対策特別措置法に基づき原子力防災管理者が通報すべき事業所外運搬に係る事象等に関する省令	原災法に基づき原子力防災管理者が通報すべき事業所外運搬に係る事象等に関する省令	原子力災害特措法に基づき原子力防災管理者が通報すべき事業所外運搬に係る事象等に関する省令																	
原子力災害対策特別措置法に基づき原子力防災管理者が通報すべき事象等に関する規則	原災法に基づき原子力防災管理者が通報すべき事象等に関する規則	原子力災害特措法に基づき原子力防災管理者が通報すべき事象等に関する規則																	
原子力災害対策特別措置法に基づく緊急事態応急対策等拠点施設等に関する内閣府令	原災法に基づく緊急事態応急対策等拠点施設等に関する内閣府令	原子力災害特措法に基づく緊急事態応急対策等拠点施設等に関する内閣府令																	
原子力災害対策特別措置法及び原子力災害対策特別措置法施行令の施行に伴う災害対策基本法施行規則の規定の読替えに関する内閣府令	原災法及び原子力災害対策特別措置法施行令の施行に伴う災害対策基本法施行規則の規定の読替えに関する内閣府令	原子力災害特措法及び原子力災害対策特別措置法施行令の施行に伴う災害対策基本法施行規則の規定の読替えに関する内閣府令																	
原子力災害対策特別措置法施行令	原災法施行令	原子力災害特措法施行令																	
原子力損害の賠償に関する法律	原賠法	原子力損害賠償法																	
原子力発電施設等立地地域の振興に関する特別措置法	原発立地地域振興特措法	原発立地振興法	原子力発電施設等立地地域振興特別措置法																
公共工事の品質確保の促進に関する法律	公共工事品確法	公共工事品質確保法																	
原子力発電施設等立地地域の振興に関する特別措置法施行令	原発立地地域振興特措法施行令	原発立地振興法施行令	原子力発電施設等立地地域振興特別措置法施行令																
原子力発電施設等立地地域の振興に関する特別措置法施行令第二条第七号に規定する原子力発電による電気の安定供給に寄与する原子力の研究及び開発の用に供する施設を定める命令	原発立地地域振興特措法施行令第二条第七号に規定する原子力発電による電気の安定供給に寄与する原子力の研究及び開発の用に供する施設を定める命令	原発立地振興法施行令第二条第七号に規定する原子力発電による電気の安定供給に寄与する原子力の研究及び開発の用に供する施設を定める命令	原子力発電施設等立地地域振興特別措置法施行令第二条第七号に規定する原子力発電による電気の安定供給に寄与する原子力の研究及び開発の用に供する施設を定める命令																
原子力発電施設等立地地域の振興に関する特別措置法施行令第八条第二項の額の算定に関する命令	原発立地地域振興特措法施行令第八条第二項の額の算定に関する命令	原発立地振興法施行令第八条第二項の額の算定に関する命令	原子力発電施設等立地地域振興特別措置法施行令第八条第二項の額の算定に関する命令																
原子力発電施設等立地地域の振興に関する特別措置法施行令第六条第三項の人口一人当たりの工業付加価値額等の算定に関する省令	原発立地地域振興特措法施行令第六条第三項の人口一人当たりの工業付加価値額等の算定に関する省令	原発立地振興法施行令第六条第三項の人口一人当たりの工業付加価値額等の算定に関する省令	原子力発電施設等立地地域振興特別措置法施行令第六条第三項の人口一人当たりの工業付加価値額等の算定に関する省令																
公立の大学における外国人教員の任用等に関する特別措置法	外国人教員法	外国人任用法																	
原子力発電施設等立地地域の振興に関する特別措置法第十条の地方税の不均一課税に伴う措置が適用される場合等を定める省令	原発立地地域振興特措法第十条の地方税の不均一課税に伴う措置が適用される場合等を定める省令	原発立地振興法第十条の地方税の不均一課税に伴う措置が適用される場合等を定める省令	原子力発電施設等立地地域振興特別措置法第十条の地方税の不均一課税に伴う措置が適用される場合等を定める省令																
原爆症認定集団訴訟の原告に係る問題の解決のための基金に対する補助に関する法律	原爆症救済法																		
個別労働関係紛争の解決の促進に関する法律第七条第一項の人数を定める政令	個別労働紛争解決促進法第七条第一項の人数を定める政令																		
湖沼水質保全特別措置法	湖沼法																		
湖沼水質保全特別措置法施行規則	湖沼法施行規則																		
湖沼水質保全特別措置法施行令	湖沼法施行令																		
雇用対策法	雇対法																		
雇用対策法施行規則	雇対法施行規則																		
雇用対策法施行令	雇対法施行令																		
後見登記等に関する法律	成年後見制度等関連四法	後見登記法																	
後進地域の開発に関する公共事業に係る国の負担割合の特例に関する法律	後進地域特例法																		
後進地域の開発に関する公共事業に係る国の負担割合の特例に関する法律施行令	後進地域特例法施行令																		
公益社団法人及び公益財団法人の認定等に関する法律	公益法人法	公益法人認定法																	
公益社団法人及び公益財団法人の認定等に関する法律施行規則	公益法人法施行規則	公益法人認定法施行規則																	
公益社団法人及び公益財団法人の認定等に関する法律施行令	公益法人法施行令	公益法人認定法施行令																	
公益社団法人及び公益財団法人の認定等に関する法律第五十条第一項に規定する合議制の機関の組織及び運営の基準を定める政令	公益法人法第五十条第一項に規定する合議制の機関の組織及び運営の基準を定める政令	公益法人認定法第五十条第一項に規定する合議制の機関の組織及び運営の基準を定める政令																	
公害の防止に関する事業に係る国の財政上の特別措置に関する法律	公害財特法																		
公害の防止に関する事業に係る国の財政上の特別措置に関する法律施行令	公害財特法施行令																		
公害健康被害の補償等に関する法律	公健法																		
公害健康被害の補償等に関する法律施行規則	公健法施行規則																		
公害健康被害の補償等に関する法律施行規程	公健法施行規程																		
公害健康被害の補償等に関する法律施行令	公健法施行令																		
公共建築物等における木材の利用の促進に関する法律	公共建築物木材利用促進法																		
公共建築物等における木材の利用の促進に関する法律施行規則	公共建築物木材利用促進法施行規則																		
公共建築物等における木材の利用の促進に関する法律施行令	公共建築物木材利用促進法施行令																		
公共工事の前払金保証事業に関する法律	保証事業法																		
公共工事の前払金保証事業に関する法律施行規則	保証事業法施行規則																		
公共工事の前払金保証事業に関する法律施行令	保証事業法施行令																		
公共工事の入札及び契約の適正化の促進に関する法律	入札契約適正化法																		
公共工事の入札及び契約の適正化の促進に関する法律施行令	入札契約適正化法施行令																		
公共用飛行場周辺における航空機騒音による障害の防止等に関する法律	航空機騒音障害防止法	航空機騒音防止法																	
公共用飛行場周辺における航空機騒音による障害の防止等に関する法律施行規則	航空機騒音障害防止法施行規則	航空機騒音防止法施行規則																	
公共用飛行場周辺における航空機騒音による障害の防止等に関する法律施行令	航空機騒音障害防止法施行令	航空機騒音防止法施行令																	
公職選挙法	公選法																		
公的年金制度の健全性及び信頼性の確保のための厚生年金保険法等の一部を改正する法律の施行に伴う経過措置に関する政令	公的年金制度の健全性及び信頼性の確保のための厚生年金法等の一部を改正する法律の施行に伴う経過措置に関する政令																		
公的年金制度の健全性及び信頼性の確保のための厚生年金保険法等の一部を改正する法律の施行に伴う厚生労働省関係省令の整備等及び経過措置に関する省令　抄	公的年金制度の健全性及び信頼性の確保のための厚生年金法等の一部を改正する法律の施行に伴う厚生労働省関係省令の整備等及び経過措置に関する省令　抄																		
公有水面埋立法	埋立法																		
公有水面埋立法施行規則	埋立法施行規則																		
公有水面埋立法施行令	埋立法施行令																		
公有地の拡大の推進に関する法律	公有地拡大推進法																		
公立の義務教育諸学校等の教育職員の給与等に関する特別措置法	教員給与特別措置法	給特法																	
公立義務教育諸学校の学級編制及び教職員定数の標準に関する法律	義務標準法	義務教育標準法																	
公立高等学校の適正配置及び教職員定数の標準等に関する法律	高校標準法																		
公立高等学校の適正配置及び教職員定数の標準等に関する法律施行令	高校標準法施行令																		
厚生年金保険の保険給付及び国民年金の給付に係る時効の特例等に関する法律	年金時効特例法																		
厚生年金保険の保険給付及び国民年金の給付の支払の遅延に係る加算金の支給に関する法律施行規則	遅延加算金法施行規則																		
厚生年金保険の保険給付及び保険料の納付の特例等に関する法律	厚生年金特例法																		
厚生年金保険の保険給付及び保険料の納付の特例等に関する法律	厚生年金特例法																		
厚生年金保険の保険給付及び保険料の納付の特例等に関する法律施行規則	厚生年金特例法施行規則																		
厚生年金保険の保険給付及び保険料の納付の特例等に関する法律施行令	厚生年金特例法施行令																		
厚生年金保険法	厚生年金法																		
厚生年金保険法施行令	厚生年金法施行令																		
厚生年金保険法施行令第三条の十六に規定する運用職員の範囲を定める省令	厚生年金法施行令第三条の十六に規定する運用職員の範囲を定める省令																		
厚生年金保険法施行令第三条の十六に規定する総括審議官等の範囲を定める省令	厚生年金法施行令第三条の十六に規定する総括審議官等の範囲を定める省令																		
厚生年金保険法第七十九条の九第一項の報告書に記載すべき事項及びその公表方法を定める省令	厚生年金法第七十九条の九第一項の報告書に記載すべき事項及びその公表方法を定める省令																		
厚生年金保険法等の一部を改正する法律の施行に伴う経過措置に関する政令	厚生年金法等の一部を改正する法律の施行に伴う経過措置に関する政令																		
厚生年金保険法等の一部を改正する法律の施行に伴う国家公務員共済組合法による長期給付等に関する経過措置に関する政令	厚生年金法等の一部を改正する法律の施行に伴う国家公務員共済組合法による長期給付等に関する経過措置に関する政令																		
厚生年金保険法等の一部を改正する法律附則第三十七条第一項の規定による旧適用法人に係る健康保険組合の設立に必要な事項等を定める政令	厚生年金法等の一部を改正する法律附則第三十七条第一項の規定による旧適用法人に係る健康保険組合の設立に必要な事項等を定める政令																		
厚生労働省関係構造改革特別区域法施行規則	厚生労働省関係特区法施行規則																		
厚生労働省関係構造改革特別区域法第三十四条に規定する政令等規制事業に係る省令の特例に関する措置を定める省令	厚生労働省関係特区法に規定する特例措置及び特定事業を定める省令																		
厚生労働省所管補助金等交付規則	中央省庁等改革関連法																		
厚生労働省設置法	中央省庁等改革関連法																		
国際的な協力の下に規制薬物に係る不正行為を助長する行為等の防止を図るための麻薬及び向精神薬取締法等の特例等に関する法律	麻薬特例法																		
広域的地域活性化のための基盤整備に関する法律	広域的地域活性化法																		
広域臨海環境整備センター法	フェニックス法	フェニックス計画法																	
広域臨海環境整備センター法施行規則	フェニックス法施行規則	フェニックス計画法施行規則																	
広域臨海環境整備センター法施行令	フェニックス法施行令	フェニックス計画法施行令																	
構造改革特別区域法	特区法	構造改革特区法																	
構造改革特別区域法施行規則	特区法施行規則	構造改革特区法施行規則																	
構造改革特別区域法施行令	特区法施行令	構造改革特区法施行令																	
構造改革特別区域法第十八条第一項に規定する高度医療の提供を行う病院又は診療所の構造設備、その有する人員等に関する基準	特区法第十八条第一項に規定する高度医療の提供を行う病院又は診療所の構造設備、その有する人員等に関する基準	構造改革特区法第十八条第一項に規定する高度医療の提供を行う病院又は診療所の構造設備、その有する人員等に関する基準																	
航空の危険を生じさせる行為等の処罰に関する法律	航空危険処罰法	航空危険行為処罰法																	
行政改革を推進するため当面講ずべき措置の一環としての国の補助金等の縮減その他の臨時の特例措置に関する法律	行革法																		
行政改革を推進するため当面講ずべき措置の一環としての国の補助金等の縮減その他の臨時の特例措置に関する法律に基づく特定地域に係る国の負担、補助等の特例に関する政令	行革法に基づく特定地域に係る国の負担、補助等の特例に関する政令																		
行政機関の保有する情報の公開に関する法律施行令第十三条第三項第一号に掲げる行政機関等が保有する行政文書に係る開示請求等の手続に関する省令	行政機関情報公開法施行令第十三条第三項第一号に掲げる行政機関等が保有する行政文書に係る開示請求等の手続に関する省令	情報公開法施行令第十三条第三項第一号に掲げる行政機関等が保有する行政文書に係る開示請求等の手続に関する省令																	
行政機関の保有する情報の公開に関する法律施行令第十三条第四項の送付に要する費用の納付方法を定める省令	行政機関情報公開法施行令第十三条第四項の送付に要する費用の納付方法を定める省令	情報公開法施行令第十三条第四項の送付に要する費用の納付方法を定める省令																	
行政手続法	行手法																		
行政手続法施行令	行手法施行令																		
行政不服審査法	行審法	行服法																	
行政不服審査法施行規則	行審法施行規則	行服法施行規則																	
行政不服審査法施行令	行審法施行令	行服法施行令																	
行旅病人及行旅死亡人取扱法	行旅法																		
鉱業等に係る土地利用の調整手続等に関する法律	土地利用調整法																		
鉱業等に係る土地利用の調整手続等に関する法律の施行等に関する規則	土地利用調整法の施行等に関する規則																		
鉱業等に係る土地利用の調整手続等に関する法律第四十七条の規定により鑑定人が受ける鑑定料の額を定める政令	土地利用調整法第四十七条の規定により鑑定人が受ける鑑定料の額を定める政令																		
高圧ガス保安法	保安四法																		
高速道路株式会社法	高速道路会社法																		
高速道路株式会社法施行規則	高速道路会社法施行規則																		
高速道路株式会社法施行令	高速道路会社法施行令																		
高齢者の医療の確保に関する法律	高齢者医療確保法																		
高齢者の医療の確保に関する法律による保険者の前期高齢者交付金等の額の算定等に関する省令	高齢者医療確保法による保険者の前期高齢者交付金等の額の算定等に関する省令																		
高齢者の医療の確保に関する法律施行規則	高齢者医療確保法施行規則																		
高齢者の医療の確保に関する法律施行令	高齢者医療確保法施行令																		
高齢者の居住の安定確保に関する法律	高齢者住まい法																		
高齢者の居住の安定確保に関する法律施行規則	高齢者住まい法施行規則																		
高齢者の居住の安定確保に関する法律施行令	高齢者住まい法施行令																		
高齢者虐待の防止、高齢者の養護者に対する支援等に関する法律施行規則	高齢者虐待防止法施行規則　																		
豪雪地帯対策特別措置法施行令	豪雪法施行令	豪雪対策法施行令	豪雪特措法施行令	豪雪地帯特措法施行令															
戦傷病者等の妻に対する特別給付金支給法施行規則	戦傷病者妻特給法施行規則																		
豪雪地帯対策特別措置法施行令第二条第二項の額の算定に関する省令	豪雪法施行令第二条第二項の額の算定に関する省令	豪雪対策法施行令第二条第二項の額の算定に関する省令	豪雪特措法施行令第二条第二項の額の算定に関する省令	豪雪地帯特措法施行令第二条第二項の額の算定に関する省令															
国と地方の協議の場に関する法律	国地方協議の場法	地域主権改革関連三法																	
国と民間企業との間の人事交流に関する法律	官民人事交流法	官民交流法																	
国と民間企業との間の人事交流に関する法律施行令	官民人事交流法施行令	官民交流法施行令																	
国の利害に関係のある訴訟についての法務大臣の権限等に関する法律	法務大臣権限法																		
国の利害に関係のある訴訟についての法務大臣の権限等に関する法律第七条第一項の公法人を定める政令	法務大臣権限法第七条第一項の公法人を定める政令																		
国家公務員共済組合法	国公共済法																		
国家公務員共済組合法による再評価率の改定等に関する政令	国公共済法による再評価率の改定等に関する政令																		
国家公務員共済組合法の規定による年金の額の改定に関する法律	国公共済法の規定による年金の額の改定に関する法律																		
国家公務員共済組合法の長期給付に関する施行法	国公共済法の長期給付に関する施行法																		
国家公務員共済組合法の年金の額の改定に関する政令	国公共済法の年金の額の改定に関する政令																		
国家公務員共済組合法施行令	国公共済法施行令																		
国等による障害者就労施設等からの物品等の調達の推進等に関する法律施行令	障害者優先調達推進法施行令																		
国家公務員共済組合法第九十条の規定による公務傷病年金等の額の改定に関する法律	国公共済法第九十条の規定による公務傷病年金等の額の改定に関する法律																		
国家公務員制度改革基本法	公務員改革法																		
国家公務員等の旅費に関する法律	旅費法																		
国家公務員法	国公法																		
国家公務員法等の一部を改正する法律の施行に伴う関係政令の整備等に関する政令　抄	国公法等の一部を改正する法律の施行に伴う関係政令の整備等に関する政令　抄																		
国家公務員法等の一部を改正する法律附則第四条第一項の政令で定める日等を定める政令	国公法等の一部を改正する法律附則第四条第一項の政令で定める日等を定める政令																		
国家戦略特別区域法	国家戦略特区法																		
国家戦略特別区域法に基づく国家戦略特別区域内の平成二十九年度に開設する医学部を置く大学に係る大学設置基準の特例に関する省令	国家戦略特区法に基づく国家戦略特別区域内の平成二十九年度に開設する医学部を置く大学に係る大学設置基準の特例に関する省令																		
国家戦略特別区域法施行規則	国家戦略特区法施行規則																		
国家戦略特別区域法施行令第三条第三号の文部科学省令で定める基準等を定める省令	国家戦略特区法施行令第三条第三号の文部科学省令で定める基準等を定める省令																		
国家戦略特別区域法第十九条の二の規定による国家公務員退職手当法の特例に関する内閣官房令	国家戦略特区法第十九条の二の規定による国家公務員退職手当法の特例に関する内閣官房令																		
国会議員の歳費、旅費及び手当等に関する法律	歳費法	国会議員歳費法																	
国会議員の選挙等の執行経費の基準に関する法律	国政選挙執行経費基準法																		
国会議事堂等周辺地域及び外国公館等周辺地域の静穏の保持に関する法律	静穏保持法																		
国際協定の締結等に伴う漁業離職者に関する臨時措置法	漁臨法	漁業離職者臨時措置法																	
国際協定の締結等に伴う漁業離職者に関する臨時措置法施行規則	漁臨法施行規則	漁業離職者臨時措置法施行規則																	
国際緊急援助隊の派遣に関する法律	国際緊急援助隊法																		
国際人道法の重大な違反行為の処罰に関する法律	国際人道法違反処罰法																		
国際人道法の重大な違反行為の処罰に関する法律第三条の重要な文化財を定める政令	国際人道法違反処罰法第三条の重要な文化財を定める政令																		
障害者虐待の防止、障害者の養護者に対する支援等に関する法律	障害者虐待防止法																		
国会議員の秘書の給与等に関する法律	国会議員秘書給与法																		
国際平和共同対処事態に際して我が国が実施する諸外国の軍隊等に対する協力支援活動等に関する法律	国際平和支援法																		
国際連合安全保障理事会決議第千八百七十四号等を踏まえ我が国が実施する貨物検査等に関する特別措置法	貨物検査法																		
国際連合安全保障理事会決議第千八百七十四号等を踏まえ我が国が実施する貨物検査等に関する特別措置法施行規則	貨物検査法施行規則																		
国際連合安全保障理事会決議第千八百七十四号等を踏まえ我が国が実施する貨物検査等に関する特別措置法施行令	貨物検査法施行令																		
国際連合安全保障理事会決議第千八百七十四号等を踏まえ我が国が実施する貨物検査等に関する特別措置法施行令第一条第一項及び別表の規定に基づき物資を定める省令	貨物検査法施行令第一条第一項及び別表の規定に基づき物資を定める省令																		
国際連合安全保障理事会決議第千八百七十四号等を踏まえ我が国が実施する貨物検査等に関する特別措置法第十条の規定により管区海上保安本部長に委任する権限を定める省令	貨物検査法第十条の規定により管区海上保安本部長に委任する権限を定める省令																		
国税犯則取締法	国犯法																		
国税犯則取締法施行規則	国犯法施行規則																		
国税犯則取締法施行規則を廃止する政令	国犯法施行規則を廃止する政令																		
国土交通省設置法	中央省庁等改革関連法																		
国土利用計画法	国土法																		
国等による障害者就労施設等からの物品等の調達の推進等に関する法律	障害者優先調達推進法																		
政治資金規正法施行令	政治資金法施行令																		
国等による障害者就労施設等からの物品等の調達の推進等に関する法律施行令第一条第二号イからハまでに規定する厚生労働省令で定める割合を定める省令	障害者優先調達推進法施行令第一条第二号イからハまでに規定する厚生労働省令で定める割合を定める省令																		
国民の祝日に関する法律	祝日法	国民祝日法																	
国民健康保険法	国健保法	国保法																	
国民健康保険法の一部を改正する法律の一部の施行に伴う経過措置に関する政令	国健保法の一部を改正する法律の一部の施行に伴う経過措置に関する政令	国保法の一部を改正する法律の一部の施行に伴う経過措置に関する政令																	
国民健康保険法の一部を改正する法律の施行に伴う国民健康保険の国庫負担金等の算定に関する政令の規定の整備及び経過措置に関する政令　抄	国健保法の施行に伴う国民健康保険の国庫負担金等の算定に関する政令の規定の整備及び経過措置に関する政令　抄	国保法の施行に伴う国民健康保険の国庫負担金等の算定に関する政令の規定の整備及び経過措置に関する政令　抄																	
国民健康保険法施行規則	国健保法施行規則	国保法施行規則																	
国民健康保険法施行法　抄	国健保法施行法　抄	国保法施行法　抄																	
国民健康保険法施行令	国健保法施行令	国保法施行令																	
国民健康保険法第四十五条第六項に規定する厚生労働大臣が指定する法人を指定する省令	国健保法第四十五条第六項に規定する厚生労働大臣が指定する法人を指定する省令	国保法第四十五条第六項に規定する厚生労働大臣が指定する法人を指定する省令																	
国民生活安定緊急措置法	生活安定法																		
国民生活安定緊急措置法施行令	生活安定法施行令																		
国立研究開発法人農業・食品産業技術総合研究機構法	農研機構法																		
国立研究開発法人農業・食品産業技術総合研究機構法施行令	農研機構法施行令																		
国立国会図書館法の規定により行政各部門に置かれる支部図書館及びその職員に関する法律	国立国会図書館支部図書館法																		
国立大学法人法	国大法人法																		
国立大学法人法の一部を改正する法律の施行に伴う関係政令の整備及び経過措置に関する政令附則第二項の規定により新富山大学法人が行うものとされる環境情報の提供の促進等による特定事業者等の環境に配慮した事業活動の促進に関する法律第九条第一項の規定による環境報告書の作成及び公表の方法を定める省令	国大法人法の一部を改正する法律の施行に伴う関係政令の整備及び経過措置に関する政令附則第二項の規定により新富山大学法人が行うものとされる環境情報の提供の促進等による特定事業者等の環境に配慮した事業活動の促進に関する法律第九条第一項の規定による環境報告書の作成及び公表の方法を定める省令																		
国立大学法人法施行規則	国大法人法施行規則																		
国立大学法人法施行令	国大法人法施行令																		
戦傷病者等の妻に対する特別給付金支給法施行令	戦傷病者妻特給法施行令																		
再生医療を国民が迅速かつ安全に受けられるようにするための施策の総合的な推進に関する法律	再生医療推進法																		
再生医療等の安全性の確保等に関する法律	再生医療安全性確保法																		
再生医療等の安全性の確保等に関する法律施行規則	再生医療安全性確保法施行規則																		
再生医療等の安全性の確保等に関する法律施行令	再生医療安全性確保法施行令																		
最低賃金法	最賃法																		
最低賃金法施行規則	最賃法施行規則																		
最低賃金法第三十五条第二項の地方運輸局を定める政令	最賃法第三十五条第二項の地方運輸局を定める政令																		
災害対策基本法	災対法																		
災害対策基本法施行規則	災対法施行規則																		
災害対策基本法施行令	災対法施行令																		
災害対策基本法第百二条第一項の徴収金等の範囲を定める省令	災対法第百二条第一項の徴収金等の範囲を定める省令																		
細菌兵器（生物兵器）及び毒素兵器の開発、生産及び貯蔵の禁止並びに廃棄に関する条約等の実施に関する法律	生物兵器禁止条約実施法	生物兵器禁止法	生物・毒素兵器禁止条約の実施法																
細菌兵器（生物兵器）及び毒素兵器の開発、生産及び貯蔵の禁止並びに廃棄に関する条約等の実施に関する法律施行令	生物兵器禁止条約実施法施行令	生物兵器禁止法施行令	生物・毒素兵器禁止条約の実施法施行令																
裁判官の報酬等に関する法律	裁判官報酬法																		
在外公館の名称及び位置並びに在外公館に勤務する外務公務員の給与に関する法律	名称位置法	在外公館名称位置給与法																	
在外公館の名称及び位置並びに在外公館に勤務する外務公務員の給与に関する法律第七条第二項の審議会等で政令で定めるものを定める政令	名称位置法第七条第二項の審議会等で政令で定めるものを定める政令	在外公館名称位置給与法第七条第二項の審議会等で政令で定めるものを定める政令																	
財政運営に必要な財源の確保を図るための公債の発行及び財政投融資特別会計からの繰入れの特例に関する法律	財源確保法																		
財政運営に必要な財源の確保を図るための特別措置に関する法律	財源確保法																		
財政構造改革の推進に関する特別措置法	財革法	財政構造改革法																	
財政構造改革の推進に関する特別措置法施行令	財革法施行令	財政構造改革法施行令																	
財務諸表等の監査証明に関する内閣府令	監査証明省令																		
財務省設置法	中央省庁等改革関連法																		
阪神・淡路大震災に対処するための国家公務員等共済組合法の特例に関する省令	子どもの貧困対策法																		
阪神・淡路大震災に対処するための私立学校教職員共済組合法の特例に関する省令	阪神・淡路大震災に対処するための私学共済法の特例に関する省令																		
産業技術力強化法	産技法																		
産業技術力強化法施行規則	産技法施行規則																		
産業技術力強化法施行令	産技法施行令																		
使用済小型電子機器等の再資源化の促進に関する法律	小型家電リサイクル法																		
使用済小型電子機器等の再資源化の促進に関する法律施行規則	小型家電リサイクル法施行規則																		
使用済小型電子機器等の再資源化の促進に関する法律施行令	小型家電リサイクル法施行令																		
使用済小型電子機器等の再資源化の促進に関する法律施行令第四条に規定する委託の基準に関する省令	小型家電リサイクル法施行令第四条に規定する委託の基準に関する省令																		
子どもの貧困対策の推進に関する法律	子どもの貧困対策法																		
子どもの貧困対策の推進に関する法律第八条第二項第二号の子どもの貧困率及び生活保護世帯に属する子どもの高等学校等進学率の定義を定める政令	子どもの貧困対策法第八条第二項第二号の子どもの貧困率及び生活保護世帯に属する子どもの高等学校等進学率の定義を定める政令																		
市町村の合併の特例に関する法律	市町村合併特例法																		
市町村の合併の特例に関する法律施行規則	市町村合併特例法施行規則																		
市町村の合併の特例に関する法律施行令	市町村合併特例法施行令																		
市町村の合併の特例等に関する法律の施行に伴う国民健康保険の保険料の賦課に関する経過措置に関する政令	市町村合併特例法の施行に伴う国民健康保険の保険料の賦課に関する経過措置に関する政令																		
私事性的画像記録の提供等による被害の防止に関する法律	リベンジポルノ規制法																		
私的独占の禁止及び公正取引の確保に関する法律の調査手続における参考人及び鑑定人の旅費及び手当に関する政令	独占禁止法の調査手続における参考人及び鑑定人の旅費及び手当に関する政令	独禁法の調査手続における参考人及び鑑定人の旅費及び手当に関する政令																	
地方交付税法施行令	交付税法施行令																		
私的独占の禁止及び公正取引の確保に関する法律第十条第三項に規定する保険業を営む会社から除くものとして公正取引委員会規則で定める会社を定める規則	独占禁止法第十条第三項に規定する保険業を営む会社から除くものとして公正取引委員会規則で定める会社を定める規則	独禁法第十条第三項に規定する保険業を営む会社から除くものとして公正取引委員会規則で定める会社を定める規則																	
私立学校教職員共済法	私学共済法																		
私立学校教職員共済法の年金の額の改定に関する政令	私学共済法の年金の額の改定に関する政令																		
私立学校教職員共済法施行規則	私学共済法施行規則																		
私立学校教職員共済法施行令	私学共済法施行令																		
児童虐待の防止等に関する法律	児童虐待防止法																		
児童虐待の防止等に関する法律施行規則	児童虐待防止法施行規則																		
児童虐待の防止等に関する法律施行令	児童虐待防止法施行令																		
児童福祉法	児福法																		
児童福祉法に基づく指定障害児相談支援の事業の人員及び運営に関する基準	児福法に基づく指定障害児相談支援の事業の人員及び運営に関する基準																		
児童福祉法に基づく指定障害児入所施設等の人員、設備及び運営に関する基準	児福法に基づく指定障害児入所施設等の人員、設備及び運営に関する基準																		
児童福祉法に基づく指定通所支援の事業等の人員、設備及び運営に関する基準	児福法に基づく指定通所支援の事業等の人員、設備及び運営に関する基準																		
児童福祉法施行規則	児福法施行規則																		
児童福祉法施行令	児福法施行令																		
児童福祉法第二十一条の九に規定する主務省令で定める事業等のうち文部科学大臣の所管するものを定める省令	児福法第二十一条の九に規定する主務省令で定める事業等のうち文部科学大臣の所管するものを定める省令																		
児童福祉法等の一部を改正する法律	児福法等の一部を改正する法律																		
持続可能な社会保障制度の確立を図るための改革の推進に関する法律	社会保障改革プログラム法																		
次世代育成支援対策推進法	次世代法																		
次世代育成支援対策推進法施行規則	次世代法施行規則																		
次世代育成支援対策推進法施行令	次世代法施行令																		
次世代育成支援対策推進法第十一条第一項に規定する交付金に関する省令	次世代法第十一条第一項に規定する交付金に関する省令																		
自殺対策基本法	自殺対策法																		
自殺対策基本法第十四条に規定する交付金に関する省令	自殺対策法第十四条に規定する交付金に関する省令																		
自転車の安全利用の促進及び自転車等の駐車対策の総合的推進に関する法律	自転車法																		
自転車競技法	競輪法																		
自転車競技法施行規則	競輪法施行規則																		
自転車競技法第三十九条第一項の期間を定める政令	競輪法第三十九条第一項の期間を定める政令																		
自動車の運転により人を死傷させる行為等の処罰に関する法律	自動車運転死傷処罰法	悪質運転厳罰法																	
失業保険法及び労働者災害補償保険法の一部を改正する法律及び労働保険の保険料の徴収等に関する法律の施行に伴う関係政令の整備等に関する政令　抄	失業保険法及び労災法の一部を改正する法律及び労働保険の保険料の徴収等に関する法律の施行に伴う関係政令の整備等に関する政令　抄																		
失業保険法及び労働者災害補償保険法の一部を改正する法律及び労働保険の保険料の徴収等に関する法律の施行に伴う関係法律の整備等に関する法律　抄	失業保険法及び労災法の一部を改正する法律及び労働保険の保険料の徴収等に関する法律の施行に伴う関係法律の整備等に関する法律　抄																		
失業保険法及び労働者災害補償保険法の一部を改正する法律及び労働保険の保険料の徴収等に関する法律の施行に伴う労働省令の整備等に関する省令　抄	失業保険法及び労災法の一部を改正する法律及び労働保険の保険料の徴収等に関する法律の施行に伴う労働省令の整備等に関する省令　抄																		
社会福祉法	社福法																		
社会福祉法施行規則	社福法施行規則																		
社会福祉法施行令	社福法施行令																		
社会保険労務士法	社労士法																		
社会保険労務士法に係る聴聞等手続規則	社労士法に係る聴聞等手続規則																		
社会保険労務士法施行規則	社労士法施行規則																		
社会保険労務士法施行令	社労士法施行令																		
社会保障協定の実施に伴う厚生年金保険法等の特例等に関する政令	社会保障協定の実施に伴う厚生年金法等の特例等に関する政令																		
社会保障協定の実施に伴う厚生年金保険法等の特例等に関する法律	社会保障協定の実施に伴う厚生年金法等の特例等に関する法律																		
社会保障協定の実施に伴う私立学校教職員共済法の特例に関する政令	社会保障協定の実施に伴う私学共済法の特例に関する政令																		
酒税の保全及び酒類業組合等に関する法律	酒団法																		
酒税の保全及び酒類業組合等に関する法律施行令	酒団法施行令																		
首都圏、近畿圏及び中部圏の近郊整備地帯等の整備のための国の財政上の特別措置に関する法律	首都圏等財特法																		
首都圏、近畿圏及び中部圏の近郊整備地帯等の整備のための国の財政上の特別措置に関する法律施行規則	首都圏等財特法施行規則																		
首都圏、近畿圏及び中部圏の近郊整備地帯等の整備のための国の財政上の特別措置に関する法律施行令	首都圏等財特法施行令																		
周辺事態に際して実施する船舶検査活動に関する法律	船舶検査法	船舶検査活動法	周辺事態船舶検査活動法																
就学困難な児童及び生徒に係る就学奨励についての国の援助に関する法律	就学奨励援助法																		
就学困難な児童及び生徒に係る就学奨励についての国の援助に関する法律施行令	就学奨励援助法施行令																		
津波防災地域づくりに関する法律	津波防災地域づくり法																		
就学前の子どもに関する教育、保育等の総合的な提供の推進に関する法律	認定こども園法																		
就学前の子どもに関する教育、保育等の総合的な提供の推進に関する法律施行規則	認定こども園法施行規則																		
就学前の子どもに関する教育、保育等の総合的な提供の推進に関する法律施行規則に係る民間事業者等が行う書面の保存等における情報通信の技術の利用に関する法律施行規則	認定こども園法施行規則に係る民間事業者等が行う書面の保存等における情報通信の技術の利用に関する法律施行規則																		
就学前の子どもに関する教育、保育等の総合的な提供の推進に関する法律施行令	認定こども園法施行令																		
住居表示に関する法律	住居表示法																		
住居表示に関する法律施行令	住居表示法施行令																		
住宅の品質確保の促進等に関する法律	住宅品質確保促進法	品確法	住宅品質確保法																
住宅の品質確保の促進等に関する法律施行令	住宅品質確保促進法施行令	品確法施行令	住宅品質確保法施行令																
住宅確保要配慮者に対する賃貸住宅の供給の促進に関する法律	住宅セーフティネット法																		
住民基本台帳法施行令第三十条の三十及び出入国管理及び難民認定法施行令第六条第三項等に規定する通知の方法を定める省令	住民基本台帳法施行令第三十条の三十及び入管法施行令第六条第三項等に規定する通知の方法を定める省令	住民基本台帳法施行令第三十条の三十及び難民認定法施行令第六条第三項等に規定する通知の方法を定める省令	住民基本台帳法施行令第三十条の三十及び出入国管理法施行令第六条第三項等に規定する通知の方法を定める省令																
出入国管理及び難民認定法及び日本国との平和条約に基づき日本の国籍を離脱した者等の出入国管理に関する特例法の一部を改正する等の法律の施行に伴う関係政令の整備及び経過措置に関する政令　抄	入管法及び日本国との平和条約に基づき日本の国籍を離脱した者等の出入国管理に関する特例法の一部を改正する等の法律の施行に伴う関係政令の整備及び経過措置に関する政令　抄	難民認定法及び日本国との平和条約に基づき日本の国籍を離脱した者等の出入国管理に関する特例法の一部を改正する等の法律の施行に伴う関係政令の整備及び経過措置に関する政令　抄	出入国管理法及び日本国との平和条約に基づき日本の国籍を離脱した者等の出入国管理に関する特例法の一部を改正する等の法律の施行に伴う関係政令の整備及び経過措置に関する政令　抄																
出入国管理及び難民認定法及び日本国との平和条約に基づき日本の国籍を離脱した者等の出入国管理に関する特例法の一部を改正する等の法律の施行に伴う法務省関係省令の整備及び経過措置に関する省令　抄	入管法及び日本国との平和条約に基づき日本の国籍を離脱した者等の出入国管理に関する特例法の一部を改正する等の法律の施行に伴う法務省関係省令の整備及び経過措置に関する省令　抄	難民認定法及び日本国との平和条約に基づき日本の国籍を離脱した者等の出入国管理に関する特例法の一部を改正する等の法律の施行に伴う法務省関係省令の整備及び経過措置に関する省令　抄	出入国管理法及び日本国との平和条約に基づき日本の国籍を離脱した者等の出入国管理に関する特例法の一部を改正する等の法律の施行に伴う法務省関係省令の整備及び経過措置に関する省令　抄																
重要影響事態に際して我が国の平和及び安全を確保するための措置に関する法律	ガイドライン関連法	周辺事態法	周辺事態安全確保法																
周辺事態に際して我が国の平和及び安全を確保するための措置に関する法律第三条第一項第四号の関係行政機関を定める政令	ガイドライン関連法第三条第一項第四号の関係行政機関を定める政令	周辺事態法第三条第一項第四号の関係行政機関を定める政令	周辺事態安全確保法第三条第一項第四号の関係行政機関を定める政令																
出入国管理及び難民認定法施行令第二条等に規定する伝達の方法等を定める省令	入管法施行令第二条等に規定する伝達の方法等を定める省令	難民認定法施行令第二条等に規定する伝達の方法等を定める省令	出入国管理法施行令第二条等に規定する伝達の方法等を定める省令																
出入国管理及び難民認定法第二十条の二第二項の基準を定める省令	入管法第二十条の二第二項の基準を定める省令	難民認定法第二十条の二第二項の基準を定める省令	出入国管理法第二十条の二第二項の基準を定める省令																
出入国管理及び難民認定法第二条第五号ロの旅券を所持する外国人の上陸申請の特例に関する法律	入管法第二条第五号ロの旅券を所持する外国人の上陸申請の特例に関する法律	難民認定法第二条第五号ロの旅券を所持する外国人の上陸申請の特例に関する法律	出入国管理法第二条第五号ロの旅券を所持する外国人の上陸申請の特例に関する法律																
出入国管理及び難民認定法第二条第五号ロの旅券を所持する外国人の上陸申請の特例に関する法律施行令	入管法第二条第五号ロの旅券を所持する外国人の上陸申請の特例に関する法律施行令	難民認定法第二条第五号ロの旅券を所持する外国人の上陸申請の特例に関する法律施行令	出入国管理法第二条第五号ロの旅券を所持する外国人の上陸申請の特例に関する法律施行令																
出入国管理及び難民認定法別表第一の二の表の技能実習の項の下欄に規定する事業上の関係を有する外国の公私の機関を定める省令	入管法別表第一の二の表の技能実習の項の下欄に規定する事業上の関係を有する外国の公私の機関を定める省令	難民認定法別表第一の二の表の技能実習の項の下欄に規定する事業上の関係を有する外国の公私の機関を定める省令	出入国管理法別表第一の二の表の技能実習の項の下欄に規定する事業上の関係を有する外国の公私の機関を定める省令																
出入国管理及び難民認定法別表第一の二の表の技能実習の項の下欄に規定する団体の要件を定める省令	入管法別表第一の二の表の技能実習の項の下欄に規定する団体の要件を定める省令	難民認定法別表第一の二の表の技能実習の項の下欄に規定する団体の要件を定める省令	出入国管理法別表第一の二の表の技能実習の項の下欄に規定する団体の要件を定める省令																
出入国管理及び難民認定法別表第一の二の表の高度専門職の項の下欄の基準を定める省令	入管法別表第一の二の表の高度専門職の項の下欄の基準を定める省令	難民認定法別表第一の二の表の高度専門職の項の下欄の基準を定める省令	出入国管理法別表第一の二の表の高度専門職の項の下欄の基準を定める省令																
女子教職員の出産に際しての補助教職員の確保に関する法律	産休法																		
小学校及び中学校の教諭の普通免許状授与に係る教育職員免許法の特例等に関する法律	小学校及び中学校の教諭の普通免許状授与に係る教育免許法の特例等に関する法律																		
小学校及び中学校の教諭の普通免許状授与に係る教育職員免許法の特例等に関する法律施行規則	小学校及び中学校の教諭の普通免許状授与に係る教育免許法の特例等に関する法律施行規則																		
小笠原諸島の復帰に伴う公職選挙法の適用の暫定措置等に関する政令	小笠原諸島の復帰に伴う公選法の適用の暫定措置等に関する政令																		
小笠原諸島振興開発特別措置法	小笠原法																		
小笠原諸島振興開発特別措置法施行規則	小笠原法施行規則																		
小笠原諸島振興開発特別措置法施行令	小笠原法施行令																		
小型自動車競走法	オートレース法																		
小売商業調整特別措置法	商調法																		
小売商業調整特別措置法施行規則	商調法施行規則																		
小売商業調整特別措置法施行令	商調法施行令																		
昭和五十九年度の財政運営に必要な財源の確保を図るための特別措置等に関する法律	財源確保法																		
昭和五十八年度の財政運営に必要な財源の確保を図るための特別措置に関する法律	財源確保法																		
昭和二十一年法律第二十四号（法人に対する政府の財政援助の制限に関する法律）	財政援助制限法																		
昭和二十二年政令第五十二号（ポツダム宣言の受諾に伴い発する命令に関する件に基く陸軍刑法を廃止する等の政令）　抄	ポツダム宣言の受諾に伴い発する命令に関する件に基く陸軍刑法を廃止する等の政令																		
昭和二十二年政令第二百六十八号（災害被害者に対する租税の減免、徴収猶予等に関する法律の施行に関する政令）	災害減免法の施行に関する政令																		
昭和二十二年法律第百七十五号（災害被害者に対する租税の減免、徴収猶予等に関する法律）	災害減免法																		
昭和六十一年度の財政運営に必要な財源の確保を図るための特別措置に関する法律	財源確保法																		
昭和六十三年度の財政運営に必要な財源の確保を図るための特別措置に関する法律	財源確保法																		
昭和六十二年度の財政運営に必要な財源の確保を図るための特別措置に関する法律	財源確保法																		
昭和六十年度の財政運営に必要な財源の確保を図るための特別措置に関する法律	財源確保法																		
障害者の日常生活及び社会生活を総合的に支援するための法律施行令	障害者総合支援法施行令																		
消費者の財産的被害の集団的な回復のための民事の裁判手続の特例に関する法律	消費者裁判手続特例法	集団訴訟法	消費者訴訟法																
消費者の財産的被害の集団的な回復のための民事の裁判手続の特例に関する法律施行規則	消費者裁判手続特例法施行規則	集団訴訟法施行規則	消費者訴訟法施行規則																
消費者安全法	消費者庁関連三法																		
消費者教育の推進に関する法律	消費者教育法	消費者教育推進法																	
消費者庁及び消費者委員会設置法	消費者庁関連三法																		
消費生活協同組合法	生協法																		
消費生活協同組合法の一部を改正する等の法律の施行に伴う経過措置に関する政令	生協法の一部を改正する等の法律の施行に伴う経過措置に関する政令																		
消費生活協同組合法施行規則	生協法施行規則																		
消費生活協同組合法施行令	生協法施行令																		
消費税の円滑かつ適正な転嫁の確保のための消費税の転嫁を阻害する行為の是正等に関する特別措置法	消費税転嫁対策特別措置法																		
消費税の円滑かつ適正な転嫁の確保のための消費税の転嫁を阻害する行為の是正等に関する特別措置法施行令	消費税転嫁対策特別措置法施行令																		
消費税の円滑かつ適正な転嫁の確保のための消費税の転嫁を阻害する行為の是正等に関する特別措置法第十五条第一項及び第二項の規定による立入検査をする金融庁等の職員の携帯する身分を示す証明書の様式を定める内閣府令	消費税転嫁対策特別措置法第十五条第一項及び第二項の規定による立入検査をする金融庁等の職員の携帯する身分を示す証明書の様式を定める内閣府令																		
消費税の円滑かつ適正な転嫁の確保のための消費税の転嫁を阻害する行為の是正等に関する特別措置法第十五条第一項又は第二項の規定による立入検査をする農林水産省の職員の携帯する身分を示す証明書の様式を定める省令	消費税転嫁対策特別措置法第十五条第一項又は第二項の規定による立入検査をする農林水産省の職員の携帯する身分を示す証明書の様式を定める省令																		
消費税の円滑かつ適正な転嫁の確保のための消費税の転嫁を阻害する行為の是正等に関する特別措置法第二条第一項第一号の大規模小売事業者を定める規則	消費税転嫁対策特別措置法第二条第一項第一号の大規模小売事業者を定める規則																		
消費税の円滑かつ適正な転嫁の確保のための消費税の転嫁を阻害する行為の是正等に関する特別措置法第八条第三号の規定による消費税に関連して取引の相手方に経済上の利益を提供する旨の表示に関する内閣府令	消費税転嫁対策特別措置法第八条第三号の規定による消費税に関連して取引の相手方に経済上の利益を提供する旨の表示に関する内閣府令																		
消防法	保安四法																		
障害を理由とする差別の解消の推進に関する法律	障害者差別解消法																		
障害を理由とする差別の解消の推進に関する法律施行規則	障害者差別解消法施行規則																		
障害を理由とする差別の解消の推進に関する法律施行令	障害者差別解消法施行令																		
障害者の日常生活及び社会生活を総合的に支援するための法律	障害者総合支援法																		
障害者の日常生活及び社会生活を総合的に支援するための法律に基づく指定計画相談支援の事業の人員及び運営に関する基準	障害者総合支援法に基づく指定計画相談支援の事業の人員及び運営に関する基準																		
障害者の日常生活及び社会生活を総合的に支援するための法律に基づく指定障害者支援施設等の人員、設備及び運営に関する基準	障害者総合支援法に基づく指定障害者支援施設等の人員、設備及び運営に関する基準																		
障害者の日常生活及び社会生活を総合的に支援するための法律に基づく指定障害福祉サービスの事業等の人員、設備及び運営に関する基準	障害者総合支援法に基づく指定障害福祉サービスの事業等の人員、設備及び運営に関する基準																		
障害者の日常生活及び社会生活を総合的に支援するための法律に基づく指定地域相談支援の事業の人員及び運営に関する基準	障害者総合支援法に基づく指定地域相談支援の事業の人員及び運営に関する基準																		
障害者の日常生活及び社会生活を総合的に支援するための法律に基づく障害者支援施設の設備及び運営に関する基準	障害者総合支援法に基づく障害者支援施設の設備及び運営に関する基準																		
障害者の日常生活及び社会生活を総合的に支援するための法律に基づく障害福祉サービス事業の設備及び運営に関する基準	障害者総合支援法に基づく障害福祉サービス事業の設備及び運営に関する基準																		
障害者の日常生活及び社会生活を総合的に支援するための法律に基づく地域活動支援センターの設備及び運営に関する基準	障害者総合支援法に基づく地域活動支援センターの設備及び運営に関する基準																		
障害者の日常生活及び社会生活を総合的に支援するための法律に基づく福祉ホームの設備及び運営に関する基準	障害者総合支援法に基づく福祉ホームの設備及び運営に関する基準																		
障害者の日常生活及び社会生活を総合的に支援するための法律施行規則	障害者総合支援法施行規則																		
地方公営企業等の労働関係に関する法律	地公労法																		
障害者虐待の防止、障害者の養護者に対する支援等に関する法律施行規則	障害者虐待防止法施行規則																		
障害者虐待の防止、障害者の養護者に対する支援等に関する法律施行令	障害者虐待防止法施行令																		
植物防疫法	植防法																		
植物防疫法施行規則	植防法施行規則																		
植物防疫法施行令	植防法施行令																		
職業安定法	職安法																		
職業安定法施行規則	職安法施行規則																		
職業安定法施行令	職安法施行令																		
食鳥処理の事業の規制及び食鳥検査に関する法律	食鳥処理法																		
食鳥処理の事業の規制及び食鳥検査に関する法律施行規則	食鳥処理法施行規則																		
食鳥処理の事業の規制及び食鳥検査に関する法律施行令	食鳥処理法施行令																		
食鳥処理の事業の規制及び食鳥検査に関する法律第二十一条第一項に規定する指定検査機関を指定する省令	食鳥処理法第二十一条第一項に規定する指定検査機関を指定する省令																		
食料・農業・農村基本法	新農業基本法																		
新幹線鉄道における列車運行の安全を妨げる行為の処罰に関する特例法	新幹線安全特例法	新幹線妨害特例法																	
新幹線鉄道における列車運行の安全を妨げる行為の処罰に関する特例法の規定を適用する新幹線鉄道の区間及び日を定める政令	新幹線安全特例法の規定を適用する新幹線鉄道の区間及び日を定める政令	新幹線妨害特例法の規定を適用する新幹線鉄道の区間及び日を定める政令																	
新幹線鉄道における列車運行の安全を妨げる行為の処罰に関する特例法施行規則	新幹線安全特例法施行規則	新幹線妨害特例法施行規則																	
森林の間伐等の実施の促進に関する特別措置法	間伐等特措法	間伐等特別措置法																	
森林の間伐等の実施の促進に関する特別措置法施行規則	間伐等特措法施行規則	間伐等特別措置法施行規則																	
森林の間伐等の実施の促進に関する特別措置法施行令	間伐等特措法施行令	間伐等特別措置法施行令																	
森林の間伐等の実施の促進に関する特別措置法第七条に規定する特定間伐等の実施又は助成に要する経費等を定める省令	間伐等特措法第七条に規定する特定間伐等の実施又は助成に要する経費等を定める省令	間伐等特別措置法第七条に規定する特定間伐等の実施又は助成に要する経費等を定める省令																	
身体障害者福祉法	身障者福祉法	身福法																	
身体障害者福祉法施行規則	身障者福祉法施行規則	身福法施行規則　																	
身体障害者福祉法施行令	身障者福祉法施行令	身福法施行令																	
身体障害者補助犬法	身障者補助犬法																		
身体障害者補助犬法施行規則	身障者補助犬法施行規則																		
身体障害者補助犬法第十六条に規定する業務を行う者を指定する省令	身障者補助犬法第十六条に規定する業務を行う者を指定する省令																		
人事訴訟法	人訴法																		
人質による強要行為等の処罰に関する法律	人質強要処罰法																		
水銀による環境の汚染の防止に関する法律	水銀環境汚染防止法																		
水銀による環境の汚染の防止に関する法律の規定に基づく立入検査等をする職員の携帯する身分を示す証明書の様式を定める命令	水銀環境汚染防止法の規定に基づく立入検査等をする職員の携帯する身分を示す証明書の様式を定める命令																		
水銀による環境の汚染の防止に関する法律施行令	水銀環境汚染防止法施行令																		
水銀による環境の汚染の防止に関する法律第十四条第四項の期間を定める省令	水銀環境汚染防止法十四条第四項の期間を定める省令																		
水銀による環境の汚染の防止に関する法律第二十九条第二項の規定に基づく権限の委任に関する省令	水銀環境汚染防止法第二十九条第二項の規定に基づく権限の委任に関する省令																		
水銀による環境の汚染の防止に関する法律第二条第二項の要件を定める省令	水銀環境汚染防止法第二条第二項の要件を定める省令																		
水産加工業施設改良資金融通臨時措置法	水産加工施設資金法																		
水産加工業施設改良資金融通臨時措置法施行令	水産加工施設資金法施行令																		
水産業協同組合法	水協法																		
水産業協同組合法の施行等に関する政令　抄	水協法の施行等に関する政令　抄																		
水産業協同組合法施行規則	水協法施行規則																		
水産業協同組合法施行令	水協法施行令																		
戦後強制抑留者に係る問題に関する特別措置法	戦後強制抑留者特別措置法	シベリア特措法																	
身体障害者補助犬法施行令	身障者補助犬法施行令	身障者補助犬法公共法人政令																	
水産業協同組合法施行令第三十条第三項から第五項までの規定による主務大臣に対する報告等に関する命令	水協法施行令第三十条第三項から第五項までの規定による主務大臣に対する報告等に関する命令																		
水産業協同組合法第百二十三条の二第三項に規定する区分等を定める命令	水協法第百二十三条の二第三項に規定する区分等を定める命令																		
水質汚濁防止法	水濁法																		
水質汚濁防止法施行規則	水濁法施行規則																		
水質汚濁防止法施行令	水濁法施行令																		
水俣病被害者の救済及び水俣病問題の解決に関する特別措置法	水俣病特措法	水俣病救済法	水俣病被害者救済法	水俣病被害者救済特別措置法															
水俣病被害者の救済及び水俣病問題の解決に関する特別措置法施行規則	水俣病特措法施行規則	水俣病救済法施行規則	水俣病被害者救済法施行規則	水俣病被害者救済特別措置法施行規則															
水俣病被害者の救済及び水俣病問題の解決に関する特別措置法施行令	水俣病特措法施行令	水俣病救済法施行令	水俣病被害者救済法施行令	水俣病被害者救済特別措置法施行令															
成田国際空港の安全確保に関する緊急措置法	成田新法	成田法																	
成田国際空港の安全確保に関する緊急措置法施行規則	成田新法施行規則	成田法施行規則																	
成田国際空港の安全確保に関する緊急措置法施行令	成田新法施行令	成田法施行令																	
成田国際空港周辺整備のための国の財政上の特別措置に関する法律	成田財特法																		
政治資金規正法	政治資金法																		
政治資金規正法施行規則	政治資金法施行規則																		
政党交付金の交付を受ける政党等に対する法人格の付与に関する法律	政党法人格付与法	政党法人化法																	
政党交付金の交付を受ける政党等に対する法人格の付与に関する法律による登記に関する各種法人等登記規則の特例を定める省令	政党法人格付与法による登記に関する各種法人等登記規則の特例を定める省令	政党法人化法による登記に関する各種法人等登記規則の特例を定める省令																	
政党交付金の交付を受ける政党等に対する法人格の付与に関する法律施行規則	政党法人格付与法施行規則	政党法人化法施行規則																	
政党助成法	政治改革関連四法																		
政府契約の支払遅延防止等に関する法律に規定する情報通信の技術の利用に関する省令	支払遅延防止法に規定する情報通信の技術の利用に関する省令																		
清酒製造業等の安定に関する特別措置法	清酒業等安定法																		
清酒製造業等の安定に関する特別措置法施行令	清酒業等安定法施行令																		
生活衛生関係営業の運営の適正化及び振興に関する法律	生活衛生関係営業適正化・振興法																		
生活衛生関係営業の運営の適正化及び振興に関する法律施行規則	生活衛生関係営業適正化・振興法施行規則																		
生活衛生関係営業の運営の適正化及び振興に関する法律施行令	生活衛生関係営業適正化・振興法施行令																		
石綿による健康被害の救済に関する法律	アスベスト救済法	石綿健康被害救済法	石綿被害者救済法	石綿救済法															
石綿による健康被害の救済に関する法律施行令	アスベスト救済法施行令	石綿健康被害救済法施行令	石綿被害者救済法施行令	石綿救済法施行令															
石油コンビナート等災害防止法	保安四法																		
石油パイプライン事業法	パイプライン事業法																		
石油パイプライン事業法施行規則	パイプライン事業法施行規則																		
石油パイプライン事業法施行令	パイプライン事業法施行令																		
積雪寒冷特別地域における道路交通の確保に関する特別措置法	雪寒法																		
積雪寒冷特別地域における道路交通の確保に関する特別措置法施行令	雪寒法施行令																		
絶滅のおそれのある野生動植物の種の保存に関する法律第三十三条の八第一項に規定する認定機関に係る民間事業者等が行う書面の保存等における情報通信の技術の利用に関する省令	種の保存法第三十三条の八第一項に規定する認定機関に係る民間事業者等が行う書面の保存等における情報通信の技術の利用に関する省令	野生動植物種保存法第三十三条の八第一項に規定する認定機関に係る民間事業者等が行う書面の保存等における情報通信の技術の利用に関する省令																	
絶滅のおそれのある野生動植物の種の保存に関する法律第二十三条第一項に規定する登録機関に係る民間事業者等が行う書面の保存等における情報通信の技術の利用に関する省令	種の保存法第二十三条第一項に規定する登録機関に係る民間事業者等が行う書面の保存等における情報通信の技術の利用に関する省令	野生動植物種保存法第二十三条第一項に規定する登録機関に係る民間事業者等が行う書面の保存等における情報通信の技術の利用に関する省令																	
戦傷病者等の妻に対する特別給付金支給法	戦傷病者妻特給法																		
戦傷病者等の妻に対する特別給付金支給法施行令第二条第一項第三号に規定する担保権者を定める省令	戦傷病者妻特給法施行令第二条第一項第三号に規定する担保権者を定める省令																		
戦傷病者等の妻に対する特別給付金支給法第四条第二項の規定により発行する国債の発行交付等に関する省令	戦傷病者妻特給法第四条第二項の規定により発行する国債の発行交付等に関する省令																		
戦没者の父母等に対する特別給付金支給法	戦没者父母特給法																		
戦没者の父母等に対する特別給付金支給法施行規則	戦没者父母特給法施行規則																		
戦没者の父母等に対する特別給付金支給法施行令	戦没者父母特給法施行令																		
戦没者の父母等に対する特別給付金支給法施行令第一条第一項第三号に規定する担保権者を定める省令	戦没者父母特給法施行令第一条第一項第三号に規定する担保権者を定める省令																		
戦没者の父母等に対する特別給付金支給法第五条第二項の規定により発行する国債の発行交付等に関する省令	戦没者父母特給法第五条第二項の規定により発行する国債の発行交付等に関する省令																		
戦没者等の妻に対する特別給付金支給法	戦没者妻特給法																		
戦没者等の妻に対する特別給付金支給法施行規則	戦没者妻特給法施行規則																		
戦没者等の妻に対する特別給付金支給法施行令	戦没者妻特給法施行令																		
津波防災地域づくりに関する法律施行規則	津波防災地域づくり法施行規則																		
戦没者等の妻に対する特別給付金支給法施行令第一条第一項第三号に規定する担保権者を定める省令	戦没者妻特給法施行令第一条第一項第三号に規定する担保権者を定める省令																		
戦没者等の妻に対する特別給付金支給法第四条第二項の規定により発行する国債の発行交付等に関する省令	戦没者妻特給法第四条第二項の規定により発行する国債の発行交付等に関する省令																		
全国新幹線鉄道整備法	新幹線整備法																		
全国新幹線鉄道整備法施行規則	新幹線整備法施行規則																		
全国新幹線鉄道整備法施行令	新幹線整備法施行令																		
租税条約等の実施に伴う所得税法、法人税法及び地方税法の特例等に関する法律	租税条約等実施特例法																		
租税条約等の実施に伴う所得税法、法人税法及び地方税法の特例等に関する法律施行令	租税条約等実施特例法施行令																		
租税特別措置法	租特法																		
租税特別措置法施行令	租特法施行令																		
租税特別措置法施行令の一部を改正する政令	租特法施行令の一部を改正する政令																		
組織的な犯罪の処罰及び犯罪収益の規制等に関する法律	組織的犯罪処罰法	組織犯罪対策三法	組織犯罪処罰法																
総合特別区域法	総合特区法																		
総合特別区域法に基づく道路運送車両法の特例に関する省令	総合特区法に基づく道路運送車両法の特例に関する省令																		
総合特別区域法施行規則	総合特区法施行規則																		
総合特別区域法施行令	総合特区法施行令																		
総務省関係構造改革特別区域法施行規則	総務省関係特区法施行規則																		
総務省関係構造改革特別区域法第三十四条に規定する政令等規制事業に係る省令の特例に関する措置を定める省令	総務省関係特区法第三十四条に規定する政令等規制事業に係る省令の特例に関する措置を定める省令																		
総務省設置法	中央省庁等改革関連法																		
多極分散型国土形成促進法	四全総法																		
滞納処分と強制執行等との手続の調整に関する法律	滞調法																		
大気汚染防止法	大防法																		
大気汚染防止法施行規則	大防法施行規則																		
大気汚染防止法施行令	大防法施行令																		
大気汚染防止法第二十一条第一項の規定に基づく自動車排出ガスによる大気の汚染の限度を定める省令	大防法第二十一条第一項の規定に基づく自動車排出ガスによる大気の汚染の限度を定める省令																		
大気汚染防止法第二条第十四項の自動車及び原動機付自転車を定める省令	大防法第二条第十四項の自動車及び原動機付自転車を定める省令																		
大規模な災害の被災地における借地借家に関する特別措置法	被災地借地借家法	大規模災害借地借家法																	
地方公営企業等の労働関係に関する法律施行令	地公労法施行令																		
大規模な災害の被災地における借地借家に関する特別措置法第二条第一項の特定大規模災害及びこれに対し適用すべき措置等を指定する政令	被災地借地借家法第二条第一項の特定大規模災害及びこれに対し適用すべき措置等を指定する政令	大規模災害借地借家法第二条第一項の特定大規模災害及びこれに対し適用すべき措置等を指定する政令																	
大規模災害からの復興に関する法律	大規模災害復興法																		
大規模災害からの復興に関する法律及び東日本大震災復興特別区域法に基づく筆界特定の申請に係る筆界特定申請情報の特例等に関する省令	大規模災害復興法及び東日本大震災復興特別区域法に基づく筆界特定の申請に係る筆界特定申請情報の特例等に関する省令																		
大規模災害からの復興に関する法律施行規則	大規模災害復興法施行規則																		
大規模災害からの復興に関する法律施行令	大規模災害復興法施行令																		
大規模災害からの復興に関する法律第十三条第二項及び第十九条第二項に規定する農林水産大臣に対する協議に関する命令	大規模災害復興法第十三条第二項及び第十九条第二項に規定する農林水産大臣に対する協議に関する命令																		
大規模災害からの復興に関する法律第十三条第六項に規定する国土交通大臣、環境大臣等に対する協議に関する命令	大規模災害復興法第十三条第六項に規定する国土交通大臣、環境大臣等に対する協議に関する命令																		
中小企業のものづくり基盤技術の高度化に関する法律	中小企業ものづくり基盤技術高度化法	中小ものづくり高度化法																	
津波防災地域づくりに関する法律施行令	津波防災地域づくり法施行令																		
大規模災害からの復興に関する法律第十七条第四項、第十八条第四項及び第九項並びに第二十条第三項に規定する国土交通大臣等に対する協議に関する命令	大規模災害復興法第十七条第四項、第十八条第四項及び第九項並びに第二十条第三項に規定する国土交通大臣等に対する協議に関する命令																		
大規模災害からの復興に関する法律第十二条第三項に規定する農林水産大臣、国土交通大臣等に対する協議に関する命令	大規模災害復興法第十二条第三項に規定する農林水産大臣、国土交通大臣等に対する協議に関する命令																		
大規模地震対策特別措置法	大震法	地震対策法																	
大規模地震対策特別措置法施行規則	大震法施行規則	地震対策法施行規則																	
大規模地震対策特別措置法施行令	大震法施行令	地震対策法施行令																	
大正十年法律第百二号（定年ニ因ル退職判事検察官ノ恩給ニ関スル法律）	定年に因る退職判事検察官の恩給に関する法律																		
大都市地域における住宅及び住宅地の供給の促進に関する特別措置法	大都市法	宅地供給促進法																	
大都市地域における住宅及び住宅地の供給の促進に関する特別措置法施行規則	大都市法施行規則	宅地供給促進法施行規則																	
大都市地域における住宅及び住宅地の供給の促進に関する特別措置法施行令	大都市法施行令	宅地供給促進法施行令																	
大都市地域における宅地開発及び鉄道整備の一体的推進に関する特別措置法	宅鉄法																		
大都市地域における宅地開発及び鉄道整備の一体的推進に関する特別措置法施行規則	宅鉄法施行規則																		
大都市地域における特別区の設置に関する法律	大都市地域特別区設置法																		
大都市地域における特別区の設置に関する法律施行規則	大都市地域特別区設置法施行規則																		
大都市地域における特別区の設置に関する法律施行令	大都市地域特別区設置法施行令																		
担保付社債信託法	担信法																		
担保付社債信託法施行規則	担信法施行規則																		
担保付社債信託法施行令	担信法施行令																		
探偵業の業務の適正化に関する法律	探偵業務適正化法	探偵業法																	
探偵業の業務の適正化に関する法律に規定する道公安委員会の権限の方面公安委員会への委任に関する政令	探偵業務適正化法に規定する道公安委員会の権限の方面公安委員会への委任に関する政令	探偵業法に規定する道公安委員会の権限の方面公安委員会への委任に関する政令																	
知的財産基本法	知財法																		
知的障害者福祉法	知福法																		
知的障害者福祉法施行規則	知福法施行規則																		
知的障害者福祉法施行令	知福法施行令																		
地域における医療及び介護の総合的な確保を推進するための関係法律の整備等に関する法律の一部の施行に伴う関係政令の整備等及び経過措置に関する政令　抄	医療・介護改革法の一部の施行に伴う関係政令の整備等及び経過措置に関する政令　抄	地域医療・介護推進法の一部の施行に伴う関係政令の整備等及び経過措置に関する政令　抄	医療・介護総合推進法の一部の施行に伴う関係政令の整備等及び経過措置に関する政令　抄	医療介護総合確保推進法の一部の施行に伴う関係政令の整備等及び経過措置に関する政令　抄															
地方公共団体の議会の議員及び長の選挙に係る電磁的記録式投票機を用いて行う投票方法等の特例に関する法律	電磁的記録投票法	電子投票法	地方選挙電子投票特例法																
地域における多様な主体の連携による生物の多様性の保全のための活動の促進等に関する法律第四条第七項に規定する都道府県知事に対する協議に関する省令	生物多様性地域連携促進法第四条第七項に規定する都道府県知事に対する協議に関する省令																		
地域における多様な主体の連携による生物の多様性の保全のための活動の促進等に関する法律第四条第二項第三号の特定非営利活動法人に準ずる者を定める省令	生物多様性地域連携促進法第四条第二項第三号の特定非営利活動法人に準ずる者を定める省令																		
地域における多様な主体の連携による生物の多様性の保全のための活動の促進等に関する法律第四条第六項に規定する環境大臣に対する協議に関する省令	生物多様性地域連携促進法第四条第六項に規定する環境大臣に対する協議に関する省令																		
地域における多様な主体の連携による生物の多様性の保全のための活動の促進等に関する法律第十五条第三項の規定により地方環境事務所長に委任する権限を定める省令	生物多様性地域連携促進法第十五条第三項の規定により地方環境事務所長に委任する権限を定める省令																		
地域における多様な需要に応じた公的賃貸住宅等の整備等に関する特別措置法	公的賃貸住宅等整備特別措置法	地域住宅特別措置法																	
地域における多様な需要に応じた公的賃貸住宅等の整備等に関する特別措置法施行規則	公的賃貸住宅等整備特別措置法施行規則	地域住宅特別措置法施行規則																	
地域における多様な需要に応じた公的賃貸住宅等の整備等に関する特別措置法施行令	公的賃貸住宅等整備特別措置法施行令	地域住宅特別措置法施行令																	
地域公共交通の活性化及び再生に関する法律	地域公共交通活性化・再生法	地域公共交通活性化法																	
長期優良住宅の普及の促進に関する法律施行規則	長期優良住宅法施行規則																		
地域公共交通の活性化及び再生に関する法律に基づく道路運送高度化実施計画、地域公共交通再編実施計画及び新地域旅客運送事業計画の認定に係る都道府県公安委員会の意見の聴取に関する命令	地域公共交通活性化・再生法に基づく道路運送高度化実施計画、地域公共交通再編実施計画及び新地域旅客運送事業計画の認定に係る都道府県公安委員会の意見の聴取に関する命令	地域公共交通活性化法に基づく道路運送高度化実施計画、地域公共交通再編実施計画及び新地域旅客運送事業計画の認定に係る都道府県公安委員会の意見の聴取に関する命令																	
地域公共交通の活性化及び再生に関する法律施行令	地域公共交通活性化・再生法施行令	地域公共交通活性化法施行令																	
地域公共交通の活性化及び再生に関する法律第十二条及び第十七条に規定する軌道運送高度化事業及び道路運送高度化事業を定める省令	地域公共交通活性化・再生法第十二条及び第十七条に規定する軌道運送高度化事業及び道路運送高度化事業を定める省令	地域公共交通活性化法第十二条及び第十七条に規定する軌道運送高度化事業及び道路運送高度化事業を定める省令																	
地域伝統芸能等を活用した行事の実施による観光及び特定地域商工業の振興に関する法律	お祭り法																		
地域伝統芸能等を活用した行事の実施による観光及び特定地域商工業の振興に関する法律第六条第一項に規定する事業を定める省令	お祭り法第六条第一項に規定する事業を定める省令																		
地域伝統芸能等を活用した行事の実施による観光及び特定地域商工業の振興に関する法律第六条第三項の率を定める政令	お祭り法第六条第三項の率を定める政令																		
地球温暖化対策の推進に関する法律施行令第二十条第二項に規定する手数料を現金により納付する場合における手続に関する省令	地球温暖化対策推進法施行令第二十条第二項に規定する手数料を現金により納付する場合における手続に関する省令	温対法施行令第二十条第二項に規定する手数料を現金により納付する場合における手続に関する省令																	
地球温暖化対策の推進に関する法律第二十二条第三項の規定に基づく主務大臣の権限の委任に関する命令	地球温暖化対策推進法第二十二条第三項の規定に基づく主務大臣の権限の委任に関する命令	温対法第二十二条第三項の規定に基づく主務大臣の権限の委任に関する命令																	
地震防災対策強化地域における地震対策緊急整備事業に係る国の財政上の特別措置に関する法律	地震財特法																		
地震防災対策強化地域における地震対策緊急整備事業に係る国の財政上の特別措置に関する法律施行規則	地震財特法施行規則																		
地震防災対策強化地域における地震対策緊急整備事業に係る国の財政上の特別措置に関する法律施行令	地震財特法施行令																		
地方教育行政の組織及び運営に関する法律	地方教育行政法	地教行法																	
地方教育行政の組織及び運営に関する法律施行令	地方教育行政法施行令	地教行法施行令																	
地方教育行政の組織及び運営に関する法律第四十七条の六第一項ただし書に規定する二以上の学校の運営に関し相互に密接な連携を図る必要がある場合を定める省令	地方教育行政法第四十七条の六第一項ただし書に規定する二以上の学校の運営に関し相互に密接な連携を図る必要がある場合を定める省令	地教行法第四十七条の六第一項ただし書に規定する二以上の学校の運営に関し相互に密接な連携を図る必要がある場合を定める省令																	
地方交付税法	交付税法																		
地方公共団体の議会の議員及び長の選挙に係る電磁的記録式投票機を用いて行う投票方法等の特例に関する法律施行規則	電磁的記録投票法施行規則	電子投票法施行規則	地方選挙電子投票特例法施行規則																
地方公共団体の議会の議員及び長の選挙に係る電磁的記録式投票機を用いて行う投票方法等の特例に関する法律施行令	電磁的記録投票法施行令	電子投票法施行令	地方選挙電子投票特例法施行令																
地方公務員法	地公法																		
地方公務員法附則第二十一項の失業者を定める省令	地公法附則第二十一項の失業者を定める省令																		
地方財政法	地財法																		
地方財政法施行令	地財法施行令																		
中小企業による地域産業資源を活用した事業活動の促進に関する法律第十三条第一項の主務省令で定める金融機関を定める省令	経営承継円滑化法第十三条第一項の主務省令で定める金融機関を定める省令	中小企業経営承継円滑化法第十三条第一項の主務省令で定める金融機関を定める省令																	
地方財政法施行令第二条第四項、第十七条第四項、第二十一条第四項及び第二十八条第三項並びに地方公共団体の財政の健全化に関する法律施行令第十四条第二項に規定する総務省令・財務省令で定める要件を定める省令	地財法施行令第二条第四項、第十七条第四項、第二十一条第四項及び第二十八条第三項並びに地方公共団体の財政の健全化に関する法律施行令第十四条第二項に規定する総務省令・財務省令で定める要件を定める省令																		
地方財政法第三十三条の五の二第一項の額の算定方法を定める省令	地財法第三十三条の五の二第一項の額の算定方法を定める省令																		
地方財政法第三十三条の五第二項第一号イ及びロ並びに第二号の額の算定に関する省令	地財法第三十三条の五第二項第一号イ及びロ並びに第二号の額の算定に関する省令																		
地方財政法第三十三条の三第二項の額の算定に関する省令	地財法第三十三条の三第二項の額の算定に関する省令																		
地方財政法第三十三条の四第二項の額の算定に関する省令	地財法第三十三条の四第二項の額の算定に関する省令																		
地方財政法第三十三条第二項第一号及び第二号の額の算定に関する省令	地財法第三十三条第二項第一号及び第二号の額の算定に関する省令																		
地方財政法第三十二条に規定する事業を定める省令	地財法第三十二条に規定する事業を定める省令																		
地方自治法	地自法																		
地方自治法施行規則	地自法施行規則																		
地方自治法施行規程	地自法施行規程																		
地方自治法施行令	地自法施行令																		
地方自治法第二百五十五条の五第一項の規定による自治紛争処理委員の審理等の手続に関する省令	地自法第二百五十五条の五第一項の規定による自治紛争処理委員の審理等の手続に関する省令																		
地方自治法第二百五十二条の十九第一項の指定都市の指定に関する政令	地自法第二百五十二条の十九第一項の指定都市の指定に関する政令																		
地方自治法第二百五十二条の二十一の三第一項に規定する総務大臣の勧告の手続に関する省令	地自法第二百五十二条の二十一の三第一項に規定する総務大臣の勧告の手続に関する省令																		
地方自治法第二百五十二条の二十二第一項の中核市の指定に関する政令	地自法第二百五十二条の二十二第一項の中核市の指定に関する政令																		
地方特例交付金等の地方財政の特別措置に関する法律	地方特例交付金法																		
地方特例交付金等の地方財政の特別措置に関する法律施行令	地方特例交付金法施行令																		
地方分権の推進を図るための関係法律の整備等に関する法律の施行に伴う国家公務員共済組合法及び国家公務員共済組合法施行令の適用の経過措置に関する政令	地方分権一括法の施行に伴う国家公務員共済組合法及び国家公務員共済組合法施行令の適用の経過措置に関する政令																		
地方分権の推進を図るための関係法律の整備等に関する法律の施行に伴う国民年金の保険料の納付に関する経過措置に関する政令	地方分権一括法の施行に伴う国民年金の保険料の納付に関する経過措置に関する政令																		
地方分権の推進を図るための関係法律の整備等に関する法律の施行に伴う国民年金の保険料の納付に関する経過措置に関する政令第二条第一項に規定する厚生労働省令で定める者等を定める省令	地方分権一括法の施行に伴う国民年金の保険料の納付に関する経過措置に関する政令第二条第一項に規定する厚生労働省令で定める者等を定める省令																		
地方分権の推進を図るための関係法律の整備等に関する法律附則第五十九条ただし書の規定に基づき地方公共団体からの別段の申出の手続を定める省令	地方分権一括法附則第五十九条ただし書の規定に基づき地方公共団体からの別段の申出の手続を定める省令																		
都市計画法施行法　抄	都計法施行法　抄																		
地方分権の推進を図るための関係法律の整備等に関する法律附則第二百二条の規定による国家公務員共済組合法の規定の技術的読替えに関する政令	地方分権一括法附則第二百二条の規定による国家公務員共済組合法の規定の技術的読替えに関する政令																		
地方分権の推進を図るための関係法律の整備等に関する法律附則第百八十四条の規定による受入金の資金への受入れ等に関する経過措置に関する政令	地方分権一括法附則第百八十四条の規定による受入金の資金への受入れ等に関する経過措置に関する政令																		
畜産物の価格安定に関する法律	畜産物価格安定法	畜安法																	
中小企業における経営の承継の円滑化に関する法律	経営承継円滑化法	中小企業経営承継円滑化法																	
中小企業における経営の承継の円滑化に関する法律施行規則	経営承継円滑化法施行規則	中小企業経営承継円滑化法施行規則																	
中小企業における経営の承継の円滑化に関する法律等の一部を改正する法律の施行期日を定める政令	経営承継円滑化法等の一部を改正する法律の施行期日を定める政令	中小企業経営承継円滑化法等の一部を改正する法律の施行期日を定める政令																	
長期優良住宅の普及の促進に関する法律施行令	長期優良住宅法施行令																		
中小企業のものづくり基盤技術の高度化に関する法律施行規則	中小企業ものづくり基盤技術高度化法施行規則	中小ものづくり高度化法施行規則																	
中小企業のものづくり基盤技術の高度化に関する法律施行令	中小企業ものづくり基盤技術高度化法施行令	中小ものづくり高度化法施行令																	
中小企業の事業活動の機会の確保のための大企業者の事業活動の調整に関する法律	分野調整法																		
中小企業の事業活動の機会の確保のための大企業者の事業活動の調整に関する法律施行規則	分野調整法施行規則																		
中小企業の事業活動の機会の確保のための大企業者の事業活動の調整に関する法律施行令	分野調整法施行令																		
中小企業団体の組織に関する法律	中小企業団体法																		
中小企業団体の組織に関する法律に係る民間事業者等が行う書面の保存等における情報通信の技術の利用に関する法律施行規則	中小企業団体法に係る民間事業者等が行う書面の保存等における情報通信の技術の利用に関する法律施行規則																		
中小企業等協同組合法	中協法																		
中小企業等協同組合法による信用協同組合及び信用協同組合連合会の事業に関する内閣府令	中協法による信用協同組合及び信用協同組合連合会の事業に関する内閣府令																		
中小企業等協同組合法に係る民間事業者等が行う書面の保存等における情報通信の技術の利用に関する法律施行規則	中協法に係る民間事業者等が行う書面の保存等における情報通信の技術の利用に関する法律施行規則																		
中小企業等協同組合法施行法　抄	中協法施行法　抄																		
中小企業等協同組合法施行法第三十六条第三項の規定による主務大臣の権限の委任に関する政令	中協法施行法第三十六条第三項の規定による主務大臣の権限の委任に関する政令																		
中小企業等協同組合法施行法第三十六条第三項の規定による組合の継続の決議の認可の申請手続に関する省令	中協法施行法第三十六条第三項の規定による組合の継続の決議の認可の申請手続に関する省令																		
中小企業等協同組合法施行令	中協法施行令																		
中小企業等協同組合法第七条第三項の規定による届出に関する規則	中協法第七条第三項の規定による届出に関する規則																		
中小企業等協同組合法等による倉荷証券発行許可等に関する省令	中協法等による倉荷証券発行許可等に関する省令																		
中小小売商業振興法	小振法																		
中小小売商業振興法施行規則	小振法施行規則																		
中小小売商業振興法施行令	小振法施行令																		
中心市街地の活性化に関する法律	中心市街地活性化法																		
中心市街地の活性化に関する法律施行規則	中心市街地活性化法施行規則																		
中心市街地の活性化に関する法律第五十四条に規定する業務に係る食品流通構造改善促進機構に関する省令	中心市街地活性化法第五十四条に規定する業務に係る食品流通構造改善促進機構に関する省令																		
中心市街地の活性化に関する法律第十五条第三項の中心市街地活性化協議会の組織の公表に関する命令	中心市街地活性化法第十五条第三項の中心市街地活性化協議会の組織の公表に関する命令																		
駐留軍等の再編の円滑な実施に関する特別措置法	米軍再編特別措置法	米軍再編特措法	米軍再編法	在日米軍再編特措法															
都市計画法施行令	都計法施行令																		
中小企業の新たな事業活動の促進に関する法律	中小企業新事業活動促進法	中促法																	
中小企業等経営強化法施行令	中小企業新事業活動促進法施行令	中促法施行令																	
駐留軍等の再編の円滑な実施に関する特別措置法第十六条に規定する業務を行う場合における株式会社国際協力銀行の会計に関する省令の特例を定める省令	米軍再編特別措置法第十六条に規定する業務を行う場合における株式会社国際協力銀行の会計に関する省令の特例を定める省令	米軍再編特措法第十六条に規定する業務を行う場合における株式会社国際協力銀行の会計に関する省令の特例を定める省令	米軍再編法第十六条に規定する業務を行う場合における株式会社国際協力銀行の会計に関する省令の特例を定める省令	在日米軍再編特措法第十六条に規定する業務を行う場合における株式会社国際協力銀行の会計に関する省令の特例を定める省令															
長期優良住宅の普及の促進に関する法律	長期優良住宅法																		
通貨の単位及び貨幣の発行等に関する法律施行規則	貨幣法施行規則																		
通貨の単位及び貨幣の発行等に関する法律施行令	貨幣法施行令																		
天災による被害農林漁業者等に対する資金の融通に関する暫定措置法	天災融資法																		
天災による被害農林漁業者等に対する資金の融通に関する暫定措置法施行規則	天災融資法施行規則																		
天災による被害農林漁業者等に対する資金の融通に関する暫定措置法施行令	天災融資法施行令																		
伝統的工芸品産業の振興に関する法律	伝産法																		
伝統的工芸品産業の振興に関する法律施行規則	伝産法施行規則																		
伝統的工芸品産業の振興に関する法律施行令	伝産法施行令																		
電気事業及び石炭鉱業における争議行為の方法の規制に関する法律	スト規制法																		
電気事業法	電事法																		
電気事業法の規定に基づく主任技術者の資格等に関する省令	電事法の規定に基づく主任技術者の資格等に関する省令																		
電気事業法関係手数料規則	電事法関係手数料規則																		
電気事業法施行規則	電事法施行規則																		
電気事業法施行令	電事法施行令																		
電気事業法第四十五条第二項に規定する指定試験機関を定める省令	電事法第四十五条第二項に規定する指定試験機関を定める省令																		
電気事業法等の一部を改正する等の法律の一部の施行期日を定める政令	電事法等の一部を改正する等の法律の一部の施行期日を定める政令																		
電気事業法等の一部を改正する等の法律の一部の施行期日を定める政令	電事法等の一部を改正する等の法律の一部の施行期日を定める政令																		
電気事業法等の一部を改正する等の法律の一部の施行期日を定める政令	電事法等の一部を改正する等の法律の一部の施行期日を定める政令																		
土壌汚染対策法	土対法																		
電気事業法等の一部を改正する等の法律の施行に伴う経過措置に関する省令	電事法等の一部を改正する等の法律の施行に伴う経過措置に関する省令																		
電気事業法等の一部を改正する等の法律の施行に伴う経過措置に関する政令	電事法等の一部を改正する等の法律の施行に伴う経過措置に関する政令																		
電気事業法等の一部を改正する等の法律の施行に伴う経過措置に関する政令第一条第二項において準用する不動産登記令第九条の情報を定める省令	電事法等の一部を改正する等の法律の施行に伴う経過措置に関する政令第一条第二項において準用する不動産登記令第九条の情報を定める省令																		
電気事業法等の一部を改正する等の法律附則第三条第一項の規定に基づき一般送配電事業者が定める託送供給等約款で設定する託送供給等約款料金の算定に関する省令	電事法等の一部を改正する等の法律附則第三条第一項の規定に基づき一般送配電事業者が定める託送供給等約款で設定する託送供給等約款料金の算定に関する省令																		
電気事業法等の一部を改正する等の法律附則第三条第一項の規定に基づき一般送配電事業者が定める託送供給等約款において定めるべき事項等に関する省令	電事法等の一部を改正する等の法律附則第三条第一項の規定に基づき一般送配電事業者が定める託送供給等約款において定めるべき事項等に関する省令																		
特許協力条約に基づく国際出願等に関する法律施行規則	国際出願法施行規則																		
特許協力条約に基づく国際出願等に関する法律施行令	国際出願法施行令																		
電気事業法等の一部を改正する等の法律附則第三条第一項の託送供給等約款の認可の申請の期限等を定める政令	電事法等の一部を改正する等の法律附則第三条第一項の託送供給等約款の認可の申請の期限等を定める政令																		
電気事業法等の一部を改正する等の法律附則第十条第一項に規定する分割証明情報に係る申請手続に関する省令	電事法等の一部を改正する等の法律附則第十条第一項に規定する分割証明情報に係る申請手続に関する省令																		
電気事業法等の一部を改正する等の法律附則第十八条第一項本文の規定に基づき一般ガス事業者が定める託送供給約款で設定する託送供給約款料金の算定に関する省令	電事法等の一部を改正する等の法律附則第十八条第一項本文の規定に基づき一般ガス事業者が定める託送供給約款で設定する託送供給約款料金の算定に関する省令																		
電気事業法等の一部を改正する等の法律附則第十八条第一項本文の規定に基づき一般ガス事業者が定める託送供給約款において定めるべき事項等に関する省令	電事法等の一部を改正する等の法律附則第十八条第一項本文の規定に基づき一般ガス事業者が定める託送供給約款において定めるべき事項等に関する省令																		
電気事業法等の一部を改正する法律の施行に伴う経過措置に関する省令	電事法等の一部を改正する法律の施行に伴う経過措置に関する省令																		
電気事業法等の一部を改正する法律附則第九条第一項の規定に基づき一般電気事業者が定める託送供給等約款で設定する託送供給等約款料金の算定に関する省令	電事法等の一部を改正する法律附則第九条第一項の規定に基づき一般電気事業者が定める託送供給等約款で設定する託送供給等約款料金の算定に関する省令																		
電気事業法等の一部を改正する法律附則第九条第一項の託送供給等約款の認可の申請の期限等を定める政令	電事法等の一部を改正する法律附則第九条第一項の託送供給等約款の認可の申請の期限等を定める政令																		
電気通信事業法	電通事法																		
電気通信事業法施行規則	電通事法施行規則																		
電気通信事業法施行令	電通事法施行令																		
電源開発促進税法	電促税法																		
電源開発促進税法施行令	電促税法施行令																		
電源開発促進法の廃止に伴う関係政令の整理及び経過措置に関する政令　抄	電促税法の廃止に伴う関係政令の整理及び経過措置に関する政令　抄																		
電子署名に係る地方公共団体の認証業務に関する法律	公的個人認証法																		
電子署名に係る地方公共団体の認証業務に関する法律施行令	公的個人認証法施行令																		
電子消費者契約及び電子承諾通知に関する民法の特例に関する法律	電子消費者契約法	電子契約法																	
電子情報処理組織による登記事務処理の円滑化のための措置等に関する法律	登記事務処理円滑化法																		
電子情報処理組織による登記事務処理の円滑化のための措置等に関する法律施行細則	登記事務処理円滑化法施行細則																		
電子情報処理組織による登記事務処理の円滑化のための措置等に関する法律第五条第二項の審議会等を定める政令	登記事務処理円滑化法第五条第二項の審議会等を定める政令																		
電話加入権質に関する臨時特例法	電質法																		
電話加入権質に関する臨時特例法施行規則	電質法施行規則																		
電話加入権質に関する臨時特例法施行令	電質法施行令																		
都市計画法	都計法																		
都市計画法施行規則	都計法施行規則																		
土壌汚染対策法に基づく指定調査機関及び指定支援法人に関する省令	土対法に基づく指定調査機関及び指定支援法人に関する省令																		
土壌汚染対策法施行規則	土対法施行規則																		
土壌汚染対策法施行令	土対法施行令																		
投資事業有限責任組合契約に関する法律	ファンド法	投資事業有限責任組合法	有責法	ＬＰＳ法															
投資事業有限責任組合契約に関する法律施行令	ファンド法施行令	投資事業有限責任組合法施行令	有責法施行令	ＬＰＳ法施行令															
投資信託及び投資法人に関する法律	投信法																		
投資信託及び投資法人に関する法律施行規則	投信法施行規則																		
投資信託及び投資法人に関する法律施行令	投信法施行令																		
東京電力原子力事故により被災した子どもをはじめとする住民等の生活を守り支えるための被災者の生活支援等に関する施策の推進に関する法律	原発事故子ども・被災者支援法	子ども・被災者支援法																	
東日本大震災からの復興のための施策を実施するために必要な財源の確保に関する特別措置法	復興財源確保法																		
特殊土壌地帯災害防除及び振興臨時措置法	特土法																		
東日本大震災による私的独占の禁止及び公正取引の確保に関する法律第九条第四項の規定による報告書の提出等の義務の不履行についての免責に係る期限に関する政令	独占禁止法第十条第三項に規定する保険業を営む会社から除くものとして公正取引委員会規則で定める会社を定める規則	独禁法第十条第三項に規定する保険業を営む会社から除くものとして公正取引委員会規則で定める会社を定める規則																	
東日本大震災に係る原子力損害賠償紛争についての原子力損害賠償紛争審査会による和解仲介手続の利用に係る時効の中断の特例に関する法律	原賠ＡＤＲ時効中断特例法																		
東日本大震災に係る原子力損害賠償紛争についての原子力損害賠償紛争審査会による和解仲介手続の利用に係る時効の中断の特例に関する法律第二条の理由を定める政令	原賠ＡＤＲ時効中断特例法第二条の理由を定める政令																		
東日本大震災に対処するための私立学校教職員共済法の特例に関する省令	東日本大震災に対処するための私学共済法の特例に関する省令																		
東日本大震災に伴う教育職員免許法及び教育公務員特例法の一部を改正する法律附則第二条第二項に規定する文部科学省令で定める期間の特例に関する省令	東日本大震災に伴う教育免許法及び教特法の一部を改正する法律附則第二条第二項に規定する文部科学省令で定める期間の特例に関する省令																		
東日本大震災の被害者の健康保険法等の一部を改正する法律附則第百三十条の二第一項の規定によりなおその効力を有するものとされた同法第二十六条の規定による改正前の介護保険法第四十八条第一項第三号の指定についての権利利益に係る満了日の延長に関する政令	東日本大震災の被害者の健保等の一部を改正する法律附則第百三十条の二第一項の規定によりなおその効力を有するものとされた同法第二十六条の規定による改正前の介護保険法第四十八条第一項第三号の指定についての権利利益に係る満了日の延長に関する政令																		
東日本大震災復興特別区域法	復興特区法																		
東日本大震災復興特別区域法施行規則	復興特区法施行規則																		
東日本大震災復興特別区域法施行令	復興特区法施行令																		
東日本大震災復興特別区域法第五十三条第五項、第五十四条第四項及び第九項並びに第五十六条第三項に規定する国土交通大臣等に対する協議に関する命令	復興特区法第五十三条第五項、第五十四条第四項及び第九項並びに第五十六条第三項に規定する国土交通大臣等に対する協議に関する命令																		
東日本大震災復興特別区域法第四十九条第二項及び第五十五条第二項に規定する農林水産大臣に対する協議に関する命令	復興特区法第四十九条第二項及び第五十五条第二項に規定する農林水産大臣に対する協議に関する命令																		
東日本大震災復興特別区域法第四十九条第六項に規定する国土交通大臣、環境大臣等に対する協議に関する命令	復興特区法第四十九条第六項に規定する国土交通大臣、環境大臣等に対する協議に関する命令																		
東日本大震災復興特別区域法第四十三条の地方税の課税免除又は不均一課税に伴う措置が適用される場合等を定める省令	復興特区法第四十三条の地方税の課税免除又は不均一課税に伴う措置が適用される場合等を定める省令																		
東日本大震災復興特別区域法第四十八条第三項に規定する農林水産大臣、国土交通大臣等に対する協議に関する命令	復興特区法第四十八条第三項に規定する農林水産大臣、国土交通大臣等に対する協議に関する命令																		
東日本大震災復興特別区域法第十八条第一項の認定の申請に係る都道府県公安委員会の意見の聴取に関する命令	復興特区法第十八条第一項の認定の申請に係る都道府県公安委員会の意見の聴取に関する命令																		
動産及び債権の譲渡の対抗要件に関する民法の特例等に関する法律	動産・債権譲渡特例法																		
道州制特別区域における広域行政の推進に関する法律	道州制特区法	道州制特区推進法																	
道州制特別区域における広域行政の推進に関する法律施行規則	道州制特区法施行規則	道州制特区推進法施行規則																	
道州制特別区域における広域行政の推進に関する法律施行令	道州制特区法施行令	道州制特区推進法施行令																	
道州制特別区域における広域行政の推進に関する法律第十九条第一項第一号の特定砂防工事交付金等の交付に関する省令	道州制特区法第十九条第一項第一号の特定砂防工事交付金等の交付に関する省令	道州制特区推進法第十九条第一項第一号の特定砂防工事交付金等の交付に関する省令																	
道州制特別区域における広域行政の推進に関する法律第十九条第一項第二号の特定保安施設事業交付金の交付に関する省令	道州制特区法第十九条第一項第二号の特定保安施設事業交付金の交付に関する省令	道州制特区推進法第十九条第一項第二号の特定保安施設事業交付金の交付に関する省令																	
道路整備事業に係る国の財政上の特別措置に関する法律	道路整備財源特例法	道路財特法	道路特例法	道路整備事業財政特別措置法															
道路整備事業に係る国の財政上の特別措置に関する法律施行規則	道路整備財源特例法施行規則	道路財特法施行規則	道路特例法施行規則	道路整備事業財政特別措置法施行規則															
道路整備事業に係る国の財政上の特別措置に関する法律施行令	道路整備財源特例法施行令	道路財特法施行令	道路特例法施行令	道路整備事業財政特別措置法施行令															
特許協力条約に基づく国際出願等に関する法律	国際出願法																		
特定Ｂ型肝炎ウイルス感染者給付金等の支給に関する特別措置法	特定Ｂ型肝炎感染者給付金支給法																		
特定Ｂ型肝炎ウイルス感染者給付金等の支給に関する特別措置法施行規則	特定Ｂ型肝炎感染者給付金支給法施行規則																		
特定Ｂ型肝炎ウイルス感染者給付金等の支給に関する特別措置法施行令	特定Ｂ型肝炎感染者給付金支給法施行令																		
特定タンカーに係る特定賠償義務履行担保契約等に関する特別措置法	イラン産原油輸送タンカー特措法	特定タンカー賠償義務履行担保契約特措法																	
特定タンカーに係る特定賠償義務履行担保契約等に関する特別措置法施行規則	イラン産原油輸送タンカー特措法施行規則	特定タンカー賠償義務履行担保契約特措法施行規則																	
特定タンカーに係る特定賠償義務履行担保契約等に関する特別措置法施行令	イラン産原油輸送タンカー特措法施行令	特定タンカー賠償義務履行担保契約特措法施行令																	
特定空港周辺航空機騒音対策特別措置法	空港周辺立地規制法																		
特定空港周辺航空機騒音対策特別措置法施行規則　　	空港周辺立地規制法施行規則																		
特定空港周辺航空機騒音対策特別措置法施行令	空港周辺立地規制法施行令																		
特定債務等の調整の促進のための特定調停に関する法律	特定調停法																		
特定商品等の預託等取引契約に関する法律	預託法	預託等取引契約法	特定商品預託法	特定商品等預託法															
特定商品等の預託等取引契約に関する法律の規定に基づく立入検査をする職員の携帯する身分を示す証明書の様式を定める内閣府令	預託法の規定に基づく立入検査をする職員の携帯する身分を示す証明書の様式を定める内閣府令	預託等取引契約法の規定に基づく立入検査をする職員の携帯する身分を示す証明書の様式を定める内閣府令	特定商品預託法の規定に基づく立入検査をする職員の携帯する身分を示す証明書の様式を定める内閣府令	特定商品等預託法の規定に基づく立入検査をする職員の携帯する身分を示す証明書の様式を定める内閣府令															
特定商品等の預託等取引契約に関する法律施行規則	預託法施行規則	預託等取引契約法施行規則	特定商品預託法施行規則	特定商品等預託法施行規則															
特定商品等の預託等取引契約に関する法律施行令	預託法施行令	預託等取引契約法施行令	特定商品預託法施行令	特定商品等預託法施行令															
特定水道利水障害の防止のための水道水源水域の水質の保全に関する特別措置法	水道水源特別措置法																		
特定水道利水障害の防止のための水道水源水域の水質の保全に関する特別措置法施行規則	水道水源特別措置法施行規則																		
特定水道利水障害の防止のための水道水源水域の水質の保全に関する特別措置法施行令	水道水源特別措置法施行令																		
特定先端大型研究施設の共用の促進に関する法律	共用促進法																		
特定先端大型研究施設の共用の促進に関する法律施行規則	共用促進法施行規則																		
特定船舶の入港の禁止に関する特別措置法	特定船舶入港禁止特措法	特定船舶入港禁止法																	
特定多国籍企業による研究開発事業等の促進に関する特別措置法	アジア拠点化推進法																		
特定多国籍企業による研究開発事業等の促進に関する特別措置法施行規則	アジア拠点化推進法施行規則																		
特定多目的ダム法	ダム法																		
特定多目的ダム法施行規則	ダム法施行規則																		
特定特殊自動車排出ガスの規制等に関する法律に係る民間事業者等が行う書面の保存等における情報通信の技術の利用に関する法律施行規則	特定特殊自動車排出ガス規制法に係る民間事業者等が行う書面の保存等における情報通信の技術の利用に関する法律施行規則																		
特定農地貸付けに関する農地法等の特例に関する法律	特定農地貸付法																		
特定農地貸付けに関する農地法等の特例に関する法律施行規則	特定農地貸付法施行規則																		
特定農地貸付けに関する農地法等の特例に関する法律施行令	特定農地貸付法施行令																		
特定農林水産物等の名称の保護に関する法律	地理的表示法																		
特定農林水産物等の名称の保護に関する法律施行規則	地理的表示法施行規則																		
特定農林水産物等の名称の保護に関する法律施行令	地理的表示法施行令																		
特定秘密の保護に関する法律	特定秘密法	特定秘密保護法																	
特定秘密の保護に関する法律施行令	特定秘密法施行令	特定秘密保護法施行令																	
農村地域工業等導入促進法施行令	農工法施行令																		
特定秘密の保護に関する法律附則第二条の政令で定める日を定める政令	特定秘密法附則第二条の政令で定める日を定める政令	特定秘密保護法附則第二条の政令で定める日を定める政令																	
特定非常災害の被害者の権利利益の保全等を図るための特別措置に関する法律	特定非常災害法	特定非常災害特別措置法																	
特定有期雇用労働者に係る労働基準法施行規則第五条の特例を定める省令	特定有期雇用労働者に係る労基法施行規則第五条の特例を定める省令																		
特別会計に関する法律	特別会計法	特会法																	
特別会計に関する法律の一部の施行に伴う関係政令の整備及び経過措置に関する政令　抄	特別会計法の一部の施行に伴う関係政令の整備及び経過措置に関する政令　抄	特会法の一部の施行に伴う関係政令の整備及び経過措置に関する政令　抄																	
特別会計に関する法律施行令第五十一条第四項第十二号に規定する経済産業省令で定める要件を定める省令	特別会計法施行令第五十一条第四項第十二号に規定する経済産業省令で定める要件を定める省令	特会法施行令第五十一条第四項第十二号に規定する経済産業省令で定める要件を定める省令																	
特別会計に関する法律施行令第五十条第五項第九号並びに第八項第七号及び第八号に規定する経済産業省令・環境省令で定める要件を定める省令	特別会計法施行令第五十条第五項第九号並びに第八項第七号及び第八号に規定する経済産業省令・環境省令で定める要件を定める省令	特会法施行令第五十条第五項第九号並びに第八項第七号及び第八号に規定する経済産業省令・環境省令で定める要件を定める省令																	
特別会計に関する法律施行令第五十二条第一項第四号に規定する事務の区分を定める命令	特別会計法施行令第五十二条第一項第四号に規定する事務の区分を定める命令	特会法施行令第五十二条第一項第四号に規定する事務の区分を定める命令																	
特別会計に関する法律施行令第五十二条第一項第二号に規定する事務の区分を定める省令	特別会計法施行令第五十二条第一項第二号に規定する事務の区分を定める省令	特会法施行令第五十二条第一項第二号に規定する事務の区分を定める省令																	
特別会計に関する法律施行令第五十二条第一項第六号に規定する事務の区分を定める省令	特別会計法施行令第五十二条第一項第六号に規定する事務の区分を定める省令	特会法施行令第五十二条第一項第六号に規定する事務の区分を定める省令																	
特別会計に関する法律施行令附則第八十九条の七の気象その他の条件を定める省令	特別会計法施行令附則第八十九条の七の気象その他の条件を定める省令	特会法施行令附則第八十九条の七の気象その他の条件を定める省令																	
特別支援学校への就学奨励に関する法律	就学奨励法																		
特別職の職員の給与に関する法律	特別職職員給与法	特別職給与法																	
特別職の職員の給与に関する法律施行令	特別職職員給与法施行令	特別職給与法施行令																	
特別職の職員の給与に関する法律施行令第一条の所得の額の算定に関する内閣官房令	特別職職員給与法施行令第一条の所得の額の算定に関する内閣官房令	特別職給与法施行令第一条の所得の額の算定に関する内閣官房令																	
毒物及び劇物取締法	毒劇物取締法	毒劇法																	
独立行政法人中小企業基盤整備機構法	中小機構法																		
独立行政法人中小企業基盤整備機構法施行令	中小機構法施行令																		
独立行政法人通則法	中央省庁等改革関連法	独法通則法																	
独立行政法人通則法の一部を改正する法律及び独立行政法人通則法の一部を改正する法律の施行に伴う関係法律の整備に関する法律の施行に伴う関係政令の整備等及び経過措置に関する政令　抄	中央省庁等改革関連法の一部を改正する法律及び独立行政法人通則法の一部を改正する法律の施行に伴う関係法律の整備に関する法律の施行に伴う関係政令の整備等及び経過措置に関する政令　抄	独法通則法の一部を改正する法律及び独立行政法人通則法の一部を改正する法律の施行に伴う関係法律の整備に関する法律の施行に伴う関係政令の整備等及び経過措置に関する政令　抄																	
農村地域工業等導入促進法第十条の地区等を定める省令	農工法第十条の地区等を定める省令																		
独立行政法人通則法等の施行に伴う関係政令の整備及び経過措置に関する政令	中央省庁等改革関連法等の施行に伴う関係政令の整備及び経過措置に関する政令	独法通則法等の施行に伴う関係政令の整備及び経過措置に関する政令																	
独立行政法人鉄道建設・運輸施設整備支援機構法	鉄運機構法																		
独立行政法人鉄道建設・運輸施設整備支援機構法施行令	鉄運機構法施行令																		
内閣府設置法	中央省庁等改革関連法																		
内国税の適正な課税の確保を図るための国外送金等に係る調書の提出等に関する法律	国外送金法																		
内国税の適正な課税の確保を図るための国外送金等に係る調書の提出等に関する法律施行令	国外送金法施行令																		
南九州畑作営農改善資金融通臨時措置法	マル南法																		
南九州畑作営農改善資金融通臨時措置法施行規則	マル南法施行規則																		
南九州畑作営農改善資金融通臨時措置法施行令	マル南法施行令																		
難病の患者に対する医療等に関する法律	難病医療法																		
難病の患者に対する医療等に関する法律施行規則	難病医療法施行規則																		
難病の患者に対する医療等に関する法律施行令	難病医療法施行令																		
日本銀行法	日銀法																		
日本銀行法施行規則	日銀法施行規則																		
日本銀行法施行令	日銀法施行令																		
日本国とアメリカ合衆国との間の相互協力及び安全保障条約第六条に基づく施設及び区域並びに日本国における合衆国軍隊の地位に関する協定の実施に伴う刑事特別法	刑事特別法	刑特法																	
日本国とアメリカ合衆国との間の相互協力及び安全保障条約第六条に基づく施設及び区域並びに日本国における合衆国軍隊の地位に関する協定の実施に伴う土地等の使用等に関する特別措置法	米軍用地特措法	駐留軍用地特別措置法																	
日本国とアメリカ合衆国との間の相互協力及び安全保障条約第六条に基づく施設及び区域並びに日本国における合衆国軍隊の地位に関する協定の実施に伴う土地等の使用等に関する特別措置法の一部を改正する法律附則第五項の規定による裁決の申請に関する省令	米軍用地特措法の一部を改正する法律附則第五項の規定による裁決の申請に関する省令	駐留軍用地特別措置法の一部を改正する法律附則第五項の規定による裁決の申請に関する省令																	
日本国とアメリカ合衆国との間の相互協力及び安全保障条約第六条に基づく施設及び区域並びに日本国における合衆国軍隊の地位に関する協定の実施に伴う土地等の使用等に関する特別措置法の一部を改正する法律附則第五項の規定による裁決の申請に関する政令	米軍用地特措法の一部を改正する法律附則第五項の規定による裁決の申請に関する政令	駐留軍用地特別措置法の一部を改正する法律附則第五項の規定による裁決の申請に関する政令																	
犯罪被害者等給付金の支給等による犯罪被害者等の支援に関する法律施行規則	犯給法施行規則																		
犯罪被害者等給付金の支給等による犯罪被害者等の支援に関する法律施行令	犯給法施行令																		
日本国とアメリカ合衆国との間の相互協力及び安全保障条約第六条に基づく施設及び区域並びに日本国における合衆国軍隊の地位に関する協定の実施に伴う土地等の使用等に関する特別措置法施行規則	米軍用地特措法施行規則	駐留軍用地特別措置法施行規則																	
日本国とアメリカ合衆国との間の相互協力及び安全保障条約第六条に基づく施設及び区域並びに日本国における合衆国軍隊の地位に関する協定の実施に伴う土地等の使用等に関する特別措置法施行令	米軍用地特措法施行令	駐留軍用地特別措置法施行令																	
日本国とアメリカ合衆国との間の相互協力及び安全保障条約第六条に基づく施設及び区域並びに日本国における合衆国軍隊の地位に関する協定の実施に伴う民事特別法	民事特別法	民特法																	
日本国と大韓民国との間の両国に隣接する大陸棚の南部の共同開発に関する協定の実施に伴う石油及び可燃性天然ガス資源の開発に関する特別措置法	日韓大陸棚法	日韓大陸棚協定の実施に伴う石油及び可燃性天然ガス資源の開発に関する特別措置法																	
日本国と大韓民国との間の両国に隣接する大陸棚の南部の共同開発に関する協定の実施に伴う石油及び可燃性天然ガス資源の開発に関する特別措置法の施行に伴う鉱山保安法に基づく省令の適用の特別措置等に関する省令	日韓大陸棚法の施行に伴う鉱山保安法に基づく省令の適用の特別措置等に関する省令	日韓大陸棚協定の実施に伴う石油及び可燃性天然ガス資源の開発に関する特別措置法の施行に伴う鉱山保安法に基づく省令の適用の特別措置等に関する省令																	
日本国と大韓民国との間の両国に隣接する大陸棚の南部の共同開発に関する協定の実施に伴う石油及び可燃性天然ガス資源の開発に関する特別措置法施行規則	日韓大陸棚法施行規則	日韓大陸棚協定の実施に伴う石油及び可燃性天然ガス資源の開発に関する特別措置法施行規則																	
日本国と大韓民国との間の両国に隣接する大陸棚の南部の共同開発に関する協定の実施に伴う石油及び可燃性天然ガス資源の開発に関する特別措置法施行令	日韓大陸棚法施行令	日韓大陸棚協定の実施に伴う石油及び可燃性天然ガス資源の開発に関する特別措置法施行令																	
日本国における国際連合の軍隊に対する刑事裁判権の行使に関する議定書の実施に伴う刑事特別法	刑事特別法	刑特法																	
日本国における国際連合の軍隊の地位に関する協定の実施に伴う刑事特別法	刑事特別法	刑特法																	
日本国に駐留するアメリカ合衆国軍隊等の行為による特別損失の補償に関する法律	特損法	特別損失補償法																	
日本国に駐留するアメリカ合衆国軍隊等の行為による特別損失の補償に関する法律施行規則	特損法施行規則	特別損失補償法施行規則																	
日本国に駐留するアメリカ合衆国軍隊等の行為による特別損失の補償に関する法律施行令	特損法施行令	特別損失補償法施行令																	
日本国有鉄道改革法	国鉄改革法																		
日本国有鉄道改革法施行規則	国鉄改革法施行規則																		
日本国有鉄道改革法施行令	国鉄改革法施行令																		
日本国有鉄道改革法第十一条第一項の規定により運輸大臣が指定する法人に使用される者に対する国家公務員等共済組合法等の規定の適用に関する政令	国鉄改革法第十一条第一項の規定により運輸大臣が指定する法人に使用される者に対する国家公務員等共済組合法等の規定の適用に関する政令																		
日本国有鉄道改革法等施行法　抄	国鉄改革法等施行法　抄																		
日本国有鉄道改革法等施行法の施行に伴う経過措置等に関する省令	国鉄改革法等施行法の施行に伴う経過措置等に関する省令																		
日本国有鉄道改革法等施行法の施行に伴う経過措置等に関する政令	国鉄改革法等施行法の施行に伴う経過措置等に関する政令																		
日本国有鉄道清算事業団の債務等の処理に関する法律	旧国鉄債務処理法																		
日本国有鉄道清算事業団の債務等の処理に関する法律施行規則	旧国鉄債務処理法施行規則																		
日本国有鉄道清算事業団の債務等の処理に関する法律施行令	旧国鉄債務処理法施行令																		
日本私立学校振興・共済事業団法	私学事業団法																		
日本電信電話株式会社の株式の売払収入の活用による社会資本の整備の促進に関する特別措置法	社会資本整備特別措置法																		
任意後見契約に関する法律	成年後見制度等関連四法																		
農業の担い手に対する経営安定のための交付金の交付に関する法律	担い手経営安定法																		
農業の担い手に対する経営安定のための交付金の交付に関する法律第三条第四項に規定する調整額及び同法第四条第二項の規定に基づく交付金の金額の算定に関する省令	担い手経営安定法第三条第四項に規定する調整額及び同法第四条第二項の規定に基づく交付金の金額の算定に関する省令																		
農業協同組合法	農協法																		
農業協同組合法、水産業協同組合法及び森林組合法による倉荷証券発行の許可の取消しに係る聴聞手続規則	農協法、水協法及び森林組合法による倉荷証券発行の許可の取消しに係る聴聞手続規則																		
農業協同組合法、水産業協同組合法及び森林組合法による倉荷証券発行の許可等に関する省令	農協法、水協法及び森林組合法による倉荷証券発行の許可等に関する省令																		
農業協同組合法の規定による消費生活協同組合又は医療法人への組織変更に関する省令	農協法の規定による消費生活協同組合又は医療法人への組織変更に関する省令																		
農業協同組合法施行規則	農協法施行規則																		
農業協同組合法施行令	農協法施行令																		
農業協同組合法施行令第六十二条第三項から第五項までの規定による主務大臣に対する報告等に関する命令	農協法施行令第六十二条第三項から第五項までの規定による主務大臣に対する報告等に関する命令																		
農業協同組合法第九十四条の二第三項に規定する区分等を定める命令	農協法第九十四条の二第三項に規定する区分等を定める命令																		
農村地域工業等導入促進法	農工法																		
農林漁業の健全な発展と調和のとれた再生可能エネルギー電気の発電の促進に関する法律	農山漁村再生可能エネルギー法																		
農林漁業の健全な発展と調和のとれた再生可能エネルギー電気の発電の促進に関する法律に基づく設備整備計画の認定等に関する省令	農山漁村再生可能エネルギー法に基づく設備整備計画の認定等に関する省令																		
農林漁業の健全な発展と調和のとれた再生可能エネルギー電気の発電の促進に関する法律施行規則	農山漁村再生可能エネルギー法施行規則																		
農林漁業の健全な発展と調和のとれた再生可能エネルギー電気の発電の促進に関する法律第五条第三項の主務省令で定める事項を定める省令	農山漁村再生可能エネルギー法第五条第三項の主務省令で定める事項を定める省令																		
農林漁業の健全な発展と調和のとれた再生可能エネルギー電気の発電の促進に関する法律第二十三条の規定により地方環境事務所長に委任する権限を定める省令	農山漁村再生可能エネルギー法第二十三条の規定により地方環境事務所長に委任する権限を定める省令																		
農林水産省関係構造改革特別区域法第三十四条に規定する政令等規制事業に係る省令の特例に関する措置を定める省令	農林水産省関係特区法に規定する特例措置及び特定事業を定める省令																		
農林水産省設置法	中央省庁等改革関連法																		
排他的経済水域及び大陸棚に関する法律	排他的経済水域大陸棚法																		
排他的経済水域及び大陸棚に関する法律第二条第二号の海域を定める政令	排他的経済水域大陸棚法第二条第二号の海域を定める政令																		
排他的経済水域及び大陸棚の保全及び利用の促進のための低潮線の保全及び拠点施設の整備等に関する法律	低潮線保全法																		
売春防止法	売防法																		
半導体集積回路の回路配置に関する法律	回路配置法	半導体集積回路法	半導体チップ法																
半導体集積回路の回路配置に関する法律に基づく登録機関に関する省令	回路配置法に基づく登録機関に関する省令	半導体集積回路法に基づく登録機関に関する省令	半導体チップ法に基づく登録機関に関する省令																
犯罪捜査のための通信傍受に関する法律	盗聴法	通信傍受法	組織犯罪対策三法																
犯罪被害財産等による被害回復給付金の支給に関する法律	被害回復給付金支給法																		
犯罪被害財産等による被害回復給付金の支給に関する法律施行規則	被害回復給付金支給法施行規則																		
犯罪被害者等の権利利益の保護を図るための刑事手続に付随する措置に関する法律	犯罪被害者等保護法																		
犯罪被害者等の権利利益の保護を図るための刑事手続に付随する措置に関する法律施行規則	犯罪被害者等保護法施行規則																		
犯罪被害者等の権利利益の保護を図るための刑事手続に付随する措置に関する法律施行令	犯罪被害者等保護法施行令																		
犯罪被害者等給付金の支給等による犯罪被害者等の支援に関する法律	犯給法																		
被災区分所有建物の再建等に関する特別措置法第二条の災害を定める政令	被災マンション法第二条の災害を定める政令																		
被災区分所有建物の再建等に関する特別措置法第二条の災害を定める政令	被災マンション法第二条の災害を定める政令																		
被災者生活再建支援法	被災者支援法																		
被用者年金制度の一元化等を図るための厚生年金保険法等の一部を改正する法律の施行に伴う経過措置に関する省令	被用者年金制度の一元化等を図るための厚生年金法等の一部を改正する法律の施行に伴う経過措置に関する省令																		
被用者年金制度の一元化等を図るための厚生年金保険法等の一部を改正する法律の施行に伴う厚生年金保険の保険給付等に関する経過措置に関する政令	被用者年金制度の一元化等を図るための厚生年金法等の一部を改正する法律の施行に伴う厚生年金保険の保険給付等に関する経過措置に関する政令																		
福島復興再生特別措置法第六十九条第二項に規定する経済産業大臣、環境大臣等に対する協議等に関する命令	福島復興再生特措法第六十九条第二項に規定する経済産業大臣、環境大臣等に対する協議等に関する命令																		
被用者年金制度の一元化等を図るための厚生年金保険法等の一部を改正する法律の施行及び国家公務員の退職給付の給付水準の見直し等のための国家公務員退職手当法等の一部を改正する法律の一部の施行に伴う国家公務員共済組合法による長期給付等に関する経過措置に関する政令	被用者年金制度の一元化等を図るための厚生年金法等の一部を改正する法律の施行及び国家公務員の退職給付の給付水準の見直し等のための国家公務員退職手当法等の一部を改正する法律の一部の施行に伴う国家公務員共済組合法による長期給付等に関する経過措置に関する政令																		
被用者年金制度の一元化等を図るための厚生年金保険法等の一部を改正する法律及び地方公務員等共済組合法及び被用者年金制度の一元化等を図るための厚生年金保険法等の一部を改正する法律の一部を改正する法律の施行に伴う地方公務員等共済組合法による長期給付等に関する経過措置に関する政令	被用者年金制度の一元化等を図るための厚生年金法等の一部を改正する法律及び地方公務員等共済組合法及び被用者年金制度の一元化等を図るための厚生年金法等の一部を改正する法律の一部を改正する法律の施行に伴う地方公務員等共済組合法による長期給付等に関する経過措置に関する政令																		
非訟事件手続法	非訟法																		
美術品の美術館における公開の促進に関する法律	美術品公開促進法																		
美術品の美術館における公開の促進に関する法律施行規則	美術品公開促進法施行規則																		
不正競争防止法	不競法																		
不正競争防止法第三十五条第三項の規定に基づく司法警察員の指定に関する規則	不競法第三十五条第三項の規定に基づく司法警察員の指定に関する規則																		
不正競争防止法第十八条第二項第三号の外国公務員等で政令で定める者を定める政令	不競法第十八条第二項第三号の外国公務員等で政令で定める者を定める政令																		
不正競争防止法第十六条第一項及び第三項並びに第十七条に規定する外国の国旗又は国の紋章その他の記章及び外国の政府若しくは地方公共団体の監督用若しくは証明用の印章又は記号並びに国際機関及び国際機関を表示する標章を定める省令	不競法第十六条第一項及び第三項並びに第十七条に規定する外国の国旗又は国の紋章その他の記章及び外国の政府若しくは地方公共団体の監督用若しくは証明用の印章又は記号並びに国際機関及び国際機関を表示する標章を定める省令																		
不動産の鑑定評価に関する法律	不動産鑑定法	不動産鑑定評価法																	
不動産の鑑定評価に関する法律施行規則	不動産鑑定法施行規則	不動産鑑定評価法施行規則																	
不動産の鑑定評価に関する法律施行令	不動産鑑定法施行令	不動産鑑定評価法施行令																	
不動産登記規則	不登規則																		
不動産登記令	不登令																		
不動産登記令第四条の特例等を定める省令	不登令第四条の特例等を定める省令																		
武力攻撃事態における外国軍用品等の海上輸送の規制に関する法律	外国軍用品等海上輸送規制法																		
武力攻撃事態における外国軍用品等の海上輸送の規制に関する法律施行令	外国軍用品等海上輸送規制法施行令																		
武力攻撃事態における捕虜等の取扱いに関する法律	捕虜取扱い法	捕虜取扱法																	
武力攻撃事態における捕虜等の取扱いに関する法律施行令	捕虜取扱い法施行令	捕虜取扱法施行令																	
武力攻撃事態等におけるアメリカ合衆国の軍隊の行動に伴い我が国が実施する措置に関する法律	米軍行動関連措置法	米軍行動円滑化法																	
武力攻撃事態等におけるアメリカ合衆国の軍隊の行動に伴い我が国が実施する措置に関する法律施行令	米軍行動関連措置法施行令	米軍行動円滑化法施行令																	
武力攻撃事態等における特定公共施設等の利用に関する法律	特定公共施設利用法																		
福島復興再生特別措置法	福島復興再生特措法																		
福島復興再生特別措置法に基づく通訳案内士法の特例に関する省令	福島復興再生特措法に基づく通訳案内士法の特例に関する省令																		
福島復興再生特別措置法に基づく流通機能向上事業に係る許認可等の特例に関する省令	福島復興再生特措法に基づく流通機能向上事業に係る許認可等の特例に関する省令																		
福島復興再生特別措置法の一部を改正する法律	福島復興再生特措法の一部を改正する法律																		
福島復興再生特別措置法の一部を改正する法律の施行に伴う関係政令の整備に関する政令	福島復興再生特措法の一部を改正する法律の施行に伴う関係政令の整備に関する政令																		
福島復興再生特別措置法施行規則	福島復興再生特措法施行規則																		
福島復興再生特別措置法施行令	福島復興再生特措法施行令																		
福島復興再生特別措置法第五十条の規定による特定健康診査等に関する記録の提供に関する省令	福島復興再生特措法第五十条の規定による特定健康診査等に関する記録の提供に関する省令																		
福島復興再生特別措置法第二十六条及び第三十八条の地方税の課税免除又は不均一課税に伴う措置が適用される場合等を定める省令	福島復興再生特措法第二十六条及び第三十八条の地方税の課税免除又は不均一課税に伴う措置が適用される場合等を定める省令																		
福島復興再生特別措置法第六十八条第二項に規定する農林水産大臣等に対する協議に関する命令	福島復興再生特措法第六十八条第二項に規定する農林水産大臣等に対する協議に関する命令																		
物価統制令	物統令																		
物価統制令施行令	物統令施行令																		
文部科学省関係構造改革特別区域法施行規則	文部科学省関係特区法施行規則																		
文部科学省関係構造改革特別区域法第三十四条に規定する政令等規制事業に係る省令の特例に関する措置を定める省令	文部科学省関係特区法に規定する特例措置及び特定事業を定める省令																		
文部科学省設置法	中央省庁等改革関連法																		
平成九年度における旧私立学校教職員共済組合法の規定による年金等の額の改定に関する政令	平成九年度における旧私学共済法の規定による年金等の額の改定に関する政令																		
平成元年度の財政運営に必要な財源の確保を図るための特別措置に関する法律	財源確保法																		
平成三十一年ラグビーワールドカップ大会特別措置法	ラグビー特措法																		
平成三十一年ラグビーワールドカップ大会特別措置法施行令	ラグビー特措法施行令																		
平成三十二年東京オリンピック競技大会・東京パラリンピック競技大会特別措置法	オリパラ特措法																		
平成三十二年東京オリンピック競技大会・東京パラリンピック競技大会特別措置法及び平成三十一年ラグビーワールドカップ大会特別措置法の施行に伴う自衛隊法施行規則等の特例に関する省令	オリパラ特措法及びラグビー特措法の施行に伴う自衛隊法施行規則等の特例に関する省令																		
平成七年度における地方財政法第三十三条の二第二項の額の算定に関する省令	平成七年度における地財法第三十三条の二第二項の額の算定に関する省令																		
平成十一年度における旧私立学校教職員共済組合法の規定による年金等の額の改定に関する政令	平成十一年度における旧私学共済法の規定による年金等の額の改定に関する政令																		
平成十九年十月以後における旧私立学校教職員共済組合法の規定による年金等の額の改定に関する政令	平成十九年十月以後における旧私学共済法の規定による年金等の額の改定に関する政令																		
平成十五年度における国民年金法による年金の額等の改定の特例に関する法律に基づく私立学校教職員共済法の年金の額の改定に関する政令	平成十五年度における国民年金法による年金の額等の改定の特例に関する法律に基づく私学共済法の年金の額の改定に関する政令																		
平成十五年度における地方財政法第三十三条の五の四の額の算定に関する省令	平成十五年度における地財法第三十三条の五の四の額の算定に関する省令																		
平成十七年度における地方財政法第三十三条の五の四の額の算定に関する省令	平成十七年度における地財法第三十三条の五の四の額の算定に関する省令																		
平成十年度における旧私立学校教職員共済組合法の規定による年金等の額の改定に関する政令	平成十年度における旧私学共済法の規定による年金等の額の改定に関する政令																		
平成十六年度における国民年金法による年金の額等の改定の特例に関する法律に基づく私立学校教職員共済法の年金の額の改定に関する政令	平成十六年度における国民年金法による年金の額等の改定の特例に関する法律に基づく私学共済法の年金の額の改定に関する政令																		
平成十六年度における地方財政法第三十三条の五の四の額の算定に関する省令	平成十六年度における地財法第三十三条の五の四の額の算定に関する省令																		
平成二十三年度における子ども手当の支給等に関する特別措置法	平成二十三年度子ども手当支給特別措置法	平成二十三年度子ども手当特別措置法																	
密集市街地における防災街区の整備の促進に関する法律施行規則	密集法施行規則																		
平成二十三年度における子ども手当の支給等に関する特別措置法に基づき市町村に交付する事務費に関する政令	平成二十三年度子ども手当支給特別措置法に基づき市町村に交付する事務費に関する政令	平成二十三年度子ども手当特別措置法に基づき市町村に交付する事務費に関する政令																	
平成二十二年四月以降において発生が確認された口蹄疫に起因して生じた事態に対処するための手当金等についての健康保険法施行令等の臨時特例に関する政令	平成二十二年四月以降において発生が確認された口蹄疫に起因して生じた事態に対処するための手当金等についての健保法施行令等の臨時特例に関する政令																		
予算決算及び会計令臨時特例	予決令臨時特例																		
予算執行職員等の責任に関する法律	予責法																		
平成二十二年四月以降において発生が確認された口蹄疫に起因して生じた事態に対処するための手当金等についての私立学校教職員共済法施行規則の臨時特例に関する省令	平成二十二年四月以降において発生が確認された口蹄疫に起因して生じた事態に対処するための手当金等についての私学共済法施行規則の臨時特例に関する省令																		
平成二年度以後における私立学校教職員共済組合法の年金の額の改定に関する政令	平成二年度以後における私学共済法の年金の額の改定に関する政令																		
平成八年度における地方財政法第三十三条の二第二項の額の算定に関する省令	平成八年度における地財法第三十三条の二第二項の額の算定に関する省令																		
平成六年度における地方財政法第三十三条の二第二項の額の算定に関する省令	平成六年度における地財法第三十三条の二第二項の額の算定に関する省令																		
米穀の新用途への利用の促進に関する法律	米粉・エサ米法	米粉・飼料用米法																	
米穀の新用途への利用の促進に関する法律施行規則	米粉・エサ米法施行規則	米粉・飼料用米法施行規則																	
米穀の新用途への利用の促進に関する法律施行令	米粉・エサ米法施行令	米粉・飼料用米法施行令																	
辺地に係る公共的施設の総合整備のための財政上の特別措置等に関する法律	辺地法																		
辺地に係る公共的施設の総合整備のための財政上の特別措置等に関する法律施行規則	辺地法施行規則																		
辺地に係る公共的施設の総合整備のための財政上の特別措置等に関する法律施行令	辺地法施行令																		
保健師助産師看護師法	保助看法																		
保健師助産師看護師法施行規則	保助看法施行規則																		
保健師助産師看護師法施行令	保助看法施行令																		
保健師助産師看護師法第三十七条の二第二項第一号に規定する特定行為及び同項第四号に規定する特定行為研修に関する省令	保助看法第三十七条の二第二項第一号に規定する特定行為及び同項第四号に規定する特定行為研修に関する省令																		
法廷等の秩序維持に関する法律	法定秩序維持法																		
法務省設置法	中央省庁等改革関連法																		
北朝鮮当局によって拉致された被害者等の支援に関する法律	拉致被害者支援法																		
北朝鮮当局によって拉致された被害者等の支援に関する法律に基づく国民年金の特例に関する省令	拉致被害者支援法国民年金特例省令																		
北朝鮮当局によって拉致された被害者等の支援に関する法律施行規則	拉致被害者支援法施行規則																		
北朝鮮当局によって拉致された被害者等の支援に関する法律施行令	拉致被害者支援法施行令																		
北朝鮮当局によって拉致された被害者等の支援に関する法律第十四条に規定する情報の提供に関する命令	拉致被害者支援法第十四条に規定する情報の提供に関する命令																		
北方領土問題等の解決の促進のための特別措置に関する法律	北方領土法																		
北方領土問題等の解決の促進のための特別措置に関する法律施行規則	北方領土法施行規則																		
北方領土問題等の解決の促進のための特別措置に関する法律施行令	北方領土法施行令																		
密集市街地における防災街区の整備の促進に関する法律	密集法																		
密集市街地における防災街区の整備の促進に関する法律による不動産登記に関する政令	密集法による不動産登記に関する政令																		
密集市街地における防災街区の整備の促進に関する法律施行令	密集法施行令																		
民間海外援助事業の推進のための物品の譲与に関する法律	海外援助推進物品譲与法																		
民事訴訟法	民訴法																		
民事訴訟法中改正法律施行法	民訴法																		
明治三十二年勅令第二百七十七号（行旅病人死亡人等ノ引取及費用弁償ニ関スル件）	行旅病人死亡人等の引取及費用弁償に関する件																		
明治十三年太政官布告第三十六号（刑法　抄）	旧刑法																		
輸出入取引法	輸取法																		
輸出入取引法に基く輸出の承認に関する省令	輸取法に基く輸出の承認に関する省令																		
輸出入取引法施行令	輸取法施行令																		
輸出入取引法第二条第四号の規定に基づく政令	輸取法第二条第四号の規定に基づく政令																		
有限責任事業組合契約に関する法律	有限責任事業組合契約法																		
有限責任事業組合契約に関する法律施行規則	有限責任事業組合契約法施行規則																		
有限責任事業組合契約に関する法律施行令	有限責任事業組合契約法施行令																		
予算決算及び会計令	予決令																		
予算執行職員等の責任に関する法律施行規則	予責法施行規則																		
予算執行職員等の責任に関する法律施行令	予責法施行令																		
予算執行職員等の責任に関する法律第十条第一項又は第十一条第一項に規定する公庫の現金出納職員又は物品管理職員がその保管に係る現金又は物品を亡失した場合等における報告に関する政令	予責法第十条第一項又は第十一条第一項に規定する公庫の現金出納職員又は物品管理職員がその保管に係る現金又は物品を亡失した場合等における報告に関する政令																		
林業労働力の確保の促進に関する法律	林野三法																		
労働安全衛生法	労安衛法	保安四法	安衛法																
労働関係調整法	労調法	労働三法																	
労働関係調整法施行令	労調法施行令																		
労働契約法	労契法																		
労働組合法	労組法	労働三法																	
労働組合法施行令	労組法施行令																		
労働保険の保険料の徴収等に関する法律	労働保険徴収法																		
労働保険の保険料の徴収等に関する法律に基づく労働保険料等の納付手続の特例に関する省令	労働保険徴収法に関する法律に基づく労働保険料等の納付手続の特例に関する省令																		
労働保険の保険料の徴収等に関する法律施行規則	労働保険徴収法施行規則																		
労働保険の保険料の徴収等に関する法律施行令	労働保険徴収法施行令																		
拉致問題その他北朝鮮当局による人権侵害問題への対処に関する法律	北朝鮮人権侵害対処法																		
小型自動車競走審判員、選手および小型自動車登録規則	オートレース登録規則																		
構造改革特別区域推進本部令	特区推進本部令																		
遺伝子組換え生物等の使用等の規制による生物の多様性の確保に関する法律第三十二条の規定による立入検査等に関する省令	カルタヘナ議定書担保法立入検査等に関する省令	カルタヘナ担保法立入検査等に関する省令																	
高齢者虐待の防止、高齢者の養護者に対する支援等に関する法律	高齢者虐待防止法																		
船舶油濁損害賠償保障法施行規則	油賠法施行規則	油濁法施行規則																	
船舶油濁損害賠償保障法施行令	油賠法施行令	油濁法施行令																	
船舶油濁損害賠償保障法	油賠法	油濁法																	
ポリ塩化ビフェニル廃棄物の適正な処理の推進に関する特別措置法	ＰＣＢ廃棄物処理法	ＰＣＢ特別措置法																	
海洋生物資源の保存及び管理に関する法律施行令	ＴＡＣ法施行令																		
確定給付企業年金法	ＤＢ法																		
確定給付企業年金法施行令	ＤＢ法施行令																		
株式会社日本政策投資銀行法	ＤＢＪ法																		
株式会社日本政策投資銀行法の一部を改正する法律附則第四条第一項の額の計算に関する省令	ＤＢＪ法の一部を改正する法律附則第四条第一項の額の計算に関する省令																		
工業標準化法に係る民間事業者等が行う書面の保存等における情報通信の技術の利用に関する法律施行規則	ＪＩＳ法に係る民間事業者等が行う書面の保存等における情報通信の技術の利用に関する法律施行規則																		
国際刑事裁判所に対する協力等に関する法律	ＩＣＣ協力法	国際刑事裁判所協力法																	
工業標準化法	ＪＩＳ法	ジス法																	
国際刑事裁判所に対する協力等に関する法律による没収保全と滞納処分との手続の調整に関する政令	ＩＣＣ協力法律による没収保全と滞納処分との手続の調整に関する政令	国際刑事裁判所協力法律による没収保全と滞納処分との手続の調整に関する政令																	
国際通貨基金及び国際復興開発銀行への加盟に伴う措置に関する法律	ＩＭＦ等加盟措置法																		
食品の製造過程の管理の高度化に関する臨時措置法	ＨＡＣＣＰ手法支援法																		
多数国間投資保証機関への加盟に伴う措置に関する法律	ＭＩＧＡ法																		
電気事業者による再生可能エネルギー電気の調達に関する特別措置法	再生可能エネルギー特措法	再生可能エネルギー特別措置法	ＦＩＴ法	再エネ特措法															
電気事業者による再生可能エネルギー電気の調達に関する特別措置法に基づく指定入札機関に関する省令	再生可能エネルギー特措法に基づく指定入札機関に関する省令	再生可能エネルギー特別措置法に基づく指定入札機関に関する省令	FIT法に基づく指定入札機関に関する省令	再エネ特措法に基づく指定入札機関に関する省令															
電気事業者による再生可能エネルギー電気の調達に関する特別措置法に基づく費用負担調整機関に関する省令	再生可能エネルギー特措法に基づく費用負担調整機関に関する省令	再生可能エネルギー特別措置法に基づく費用負担調整機関に関する省令	ＦＩＴ法に基づく費用負担調整機関に関する省令	再エネ特措法に基づく費用負担調整機関に関する省令															
電気事業者による再生可能エネルギー電気の調達に関する特別措置法施行規則	再生可能エネルギー特措法施行規則	再生可能エネルギー特別措置法施行規則	Ｆ法施行規則	再エネ特措法施行規則															
電気事業者による再生可能エネルギー電気の調達に関する特別措置法施行令	再生可能エネルギー特措法施行令	再生可能エネルギー特別措置法施行令	ＦＩＴ法施行令	再エネ特措法施行令															
電気事業者による再生可能エネルギー電気の調達に関する特別措置法等の一部を改正する法律の施行に伴う関係政令の整備及び経過措置に関する政令	再生可能エネルギー特措法等の一部を改正する法律の施行に伴う関係政令の整備及び経過措置に関する政令	再生可能エネルギー特別措置法等の一部を改正する法律の施行に伴う関係政令の整備及び経過措置に関する政令	Ｆ法等の一部を改正する法律の施行に伴う関係政令の整備及び経過措置に関する政令	再エネ特措法等の一部を改正する法律の施行に伴う関係政令の整備及び経過措置に関する政令															
電気用品安全法	電安法	ＰＳＥ法																	
電気用品安全法施行規則	電安法施行規則	ＰＳＥ法施行規則																	
電気用品安全法施行令	電安法施行令	ＰＳＥ法施行令																	
特定非営利活動促進法	ＮＰＯ法																		
特定非営利活動促進法施行規則	ＮＰＯ法施行規則																		
特定非営利活動促進法施行令	ＮＰＯ法施行令																		
独立行政法人石油天然ガス・金属鉱物資源機構法	ＪＯＧＭＥＣ法																		
独立行政法人石油天然ガス・金属鉱物資源機構法施行令	ＪＯＧＭＥＣ法施行令																		
日米相互防衛援助協定等に伴う秘密保護法	防衛秘密保護法	日米秘密保護法	ＭＤＡ秘密保護法	ＭＳＡ秘密保護法															
日米相互防衛援助協定等に伴う秘密保護法施行令	防衛秘密保護法施行令	日米秘密保護法施行令	ＭＤＡ秘密保護法施行令	ＭＳＡ秘密保護法施行令															
日本中央競馬会法	ＪＲＡ法																		
日本中央競馬会法施行規則	ＪＲＡ法施行規則																		
日本中央競馬会法施行令	ＪＲＡ法施行令																		
排他的経済水域における漁業等に関する主権的権利の行使等に関する法律	ＥＥＺ漁業法	漁業主権法																	
排他的経済水域における漁業等に関する主権的権利の行使等に関する法律施行規則	ＥＥＺ漁業法施行規則	漁業主権法施行規則																	
排他的経済水域における漁業等に関する主権的権利の行使等に関する法律施行令	ＥＥＺ漁業法施行令	漁業主権法施行令																	
排他的経済水域における漁業等に関する主権的権利の行使等に関する法律第二十四条第一項に規定する事件に関する拿捕に係る担保金の提供等に関する命令	ＥＥＺ漁業法第二十四条第一項に規定する事件に関する拿捕に係る担保金の提供等に関する命令	漁業主権法第二十四条第一項に規定する事件に関する拿捕に係る担保金の提供等に関する命令																	
国際協定の締結等に伴う漁業離職者に関する臨時措置法施行令	漁臨法施行令	漁業離職者臨時措置法施行令																	
公立義務教育諸学校の学級編制及び教職員定数の標準に関する法律施行令	義務標準法施行令	義務教育標準法施行令																	
公立義務教育諸学校の学級編制及び教職員定数の標準に関する法律施行規則	義務標準法施行規則	義務教育標準法施行規則																	
原子力損害の賠償に関する法律施行令	原賠法施行令	原子力損害賠償法施行令																	
激甚災害に対処するための特別の財政援助等に関する法律施行令	激甚法施行令	激甚災害法施行令																	
原子力損害の賠償に関する法律施行規則	原賠法施行規則	原子力損害賠償法施行規則																	
豪雪地帯対策特別措置法	豪雪法	豪雪対策法	豪雪特措法	豪雪地帯特措法															
激甚災害に対処するための特別の財政援助等に関する法律施行令第十八条第一項の特別措置適用申請書に関する省令	激甚法施行令第十八条第一項の特別措置適用申請書に関する省令	激甚災害法施行令第十八条第一項の特別措置適用申請書に関する省令																	
日本私立学校振興・共済事業団法施行令	私学事業団法施行令																		
南極地域の環境の保護に関する法律施行令	南極保護法施行令	南極環境保護法施行令																	
南極地域の環境の保護に関する法律施行規則	南極保護法施行規則	南極環境保護法施行規則																	
日本私立学校振興・共済事業団法施行規則	私学事業団法施行規則																		
南極地域の環境の保護に関する法律	南極保護法	南極環境保護法																	
国会議員の選挙等の執行経費の基準に関する法律施行令	国政選挙執行経費基準法施行令																		
容器包装に係る分別収集及び再商品化の促進等に関する法律に係る民間事業者等が行う書面の保存等における情報通信の技術の利用に関する法律施行規則	容器包装リサイクル法施行規則	容リ法施行規則																	
住宅の品質確保の促進等に関する法律施行規則	住宅品質確保促進法施行規則	品確法施行規則施行規則	住宅品質確保法施行規則																
被災者生活再建支援法施行令	被災者支援法施行令																		
被災者生活再建支援法施行規則	被災者支援法施行規則																		
刑事収容施設及び被収容者等の処遇に関する法律施行令	刑事施設法施行令	刑事収容施設法施行令																	
武力攻撃事態等における特定公共施設等の利用に関する法律施行令	特定公共施設利用法施行令																		
大学等における技術に関する研究成果の民間事業者への移転の促進に関する法律施行規則	大学等技術移転促進法施行規則	ＴＬＯ法																	
平成二十三年度における子ども手当の支給等に関する特別措置法施行規則	平成二十三年度子ども手当支給特別措置法施行規則	平成二十三年度子ども手当特別措置法施行規則																	
平成二十三年度における子ども手当の支給等に関する特別措置法施行令	平成二十三年度子ども手当支給特別措置法施行令	平成二十三年度子ども手当特別措置法施行令																	
消費者の財産的被害の集団的な回復のための民事の裁判手続の特例に関する法律施行令	消費者裁判手続特例法施行令	集団訴訟法施行令	消費者訴訟法施行令																
平成三十二年東京オリンピック競技大会・東京パラリンピック競技大会特別措置法施行令	オリパラ特措法施行令																		
中小企業における経営の承継の円滑化に関する法律施行令	経営承継円滑化法施行令	中小企業経営承継円滑化法施行令																	
国家戦略特別区域法施行令	国家戦略特区法施行令																		
自動車の運転により人を死傷させる行為等の処罰に関する法律施行令	自動車運転死傷処罰法施行令	悪質運転厳罰法施行令																	
特定住宅金融専門会社の債権債務の処理の促進等に関する特別措置法施行令	住専処理法施行	住専法施行令																	
特定住宅金融専門会社の債権債務の処理の促進等に関する特別措置法施行規則	住専処理法施行規則	住専法施行規則																	
特定住宅金融専門会社の債権債務の処理の促進等に関する特別措置法	住専処理法	住専法																	
政党助成法施行規則	政党助成法施行規則																		
政党助成法施行令	政党助成法施行令																		
原子爆弾被爆者に対する援護に関する法律	被爆者援護法	原爆被爆者援護法	原爆三法																
原子爆弾被爆者に対する援護に関する法律施行令	被爆者援護法施行令	原爆被爆者援護法施行令																	
衆議院議員選挙区画定審議会設置法	区画審設置法	政治改革関連四法																	
衆議院議員選挙区画定審議会設置法施行令	区画審設置法施行令																		
救急医療用ヘリコプターを用いた救急医療の確保に関する特別措置法施行令	ドクターヘリ法に規定する助成金交付事業に係る登録に関する省令	ドクターヘリ特別措置法に規定する助成金交付事業に係る登録に関する省令																	
原子爆弾被爆者に対する援護に関する法律施行規則	被爆者援護法施行規則	原爆被爆者援護法施行規則	原爆三法施行規則																
厚生年金保険の保険給付及び国民年金の給付に係る時効の特例等に関する法律施行規則	年金時効特例法施行規則																		
厚生年金保険の保険給付及び国民年金の給付に係る時効の特例等に関する法律施行令	年金時効特例法施行令																		
広域的地域活性化のための基盤整備に関する法律施行規則	広域的地域活性化法施行規則																		
広域的地域活性化のための基盤整備に関する法律施行令	広域的地域活性化法施行令																		
国立大学法人法の一部を改正する法律の施行に伴う関係政令の整備及び経過措置に関する政令　抄	国大法人法の一部を改正する法律の施行に伴う関係政令の整備及び経過措置に関する政令　抄																		
国立大学法人法の一部を改正する法律の施行に伴う関係政令の整備及び経過措置に関する政令　抄	国大法人法の一部を改正する法律の施行に伴う関係政令の整備及び経過措置に関する政令　抄																		
国立大学法人法の一部を改正する法律の施行に伴う経過措置に関する省令	国大法人法の一部を改正する法律の施行に伴う経過措置に関する省令																		
社会保障協定の実施に伴う国民年金法施行規則及び厚生年金保険法施行規則の特例等に関する省令	社会保障協定の実施に伴う国民年金法施行規則及び厚生年金法施行規則の特例等に関する省令																		
社会保障協定の実施に伴う私立学校教職員共済法施行規則の特例等に関する省令	社会保障協定の実施に伴う私学共済法施行規則の特例等に関する省令																		
成田国際空港周辺整備のための国の財政上の特別措置に関する法律施行令	成田財特法施行令																		
探偵業の業務の適正化に関する法律施行規則	探偵業務適正化法施行規則	探偵業法施行規則																	
地域公共交通の活性化及び再生に関する法律施行規則	地域公共交通活性化・再生法施行規則	地域公共交通活性化法施行規則																	
地方財政法施行令附則第六条第一項に規定する総務省令・財務省令で定める数値及び事項を定める省令	地財法施行令附則第六条第一項に規定する総務省令・財務省令で定める数値及び事項を定める省令																		
中小企業等協同組合法施行規則	中協法施行規則																		
中心市街地の活性化に関する法律施行令	中心市街地活性化法施行令																		
駐留軍等の再編の円滑な実施に関する特別措置法施行規則	米軍再編特別措置法施行規則	米軍再編特措法施行規則	米軍再編法施行規則	在日米軍再編特措法施行規則															
駐留軍等の再編の円滑な実施に関する特別措置法施行令	米軍再編特別措置法施行令	米軍再編特措法施行令	米軍再編法施行令	在日米軍再編特措法施行令															
駐留軍等の再編の円滑な実施に関する特別措置法施行令第七条第三項の額の算定に関する命令	米軍再編特別措置法施行令第七条第三項の額の算定に関する命令	米軍再編特措法施行令第七条第三項の額の算定に関する命令	米軍再編法施行令第七条第三項の額の算定に関する命令	在日米軍再編特措法施行令第七条第三項の額の算定に関する命令															
特定多国籍企業による研究開発事業等の促進に関する特別措置法施行令	アジア拠点化推進法施行令																		
特別会計に関する法律施行令	特別会計法施行令	特会法施行令																	
特別会計に関する法律施行令第十六条第一項第四号の規定に基づく農作物共済、果樹共済及び畑作物共済に係る再保険金及び保険金の概算払の額の限度に関する省令	特別会計法施行令第十六条第一項第四号の規定に基づく農作物共済、果樹共済及び畑作物共済に係る再保険金及び保険金の概算払の額の限度に関する省令	特会法施行令第十六条第一項第四号の規定に基づく農作物共済、果樹共済及び畑作物共済に係る再保険金及び保険金の概算払の額の限度に関する省令																	
特別支援学校への就学奨励に関する法律施行規則	就学奨励法施行規則																		
特別支援学校への就学奨励に関する法律施行令	就学奨励法施行令																		
農業の担い手に対する経営安定のための交付金の交付に関する法律施行規則	担い手経営安定法施行規則																		
農業の担い手に対する経営安定のための交付金の交付に関する法律施行令	担い手経営安定法施行令																		
平成二十二年四月以降において発生が確認された口蹄疫に起因して生じた事態に対処するための手当金等についての健康保険法施行規則等の臨時特例に関する省令	平成二十二年四月以降において発生が確認された口蹄疫に起因して生じた事態に対処するための手当金等についての健保法施行規則等の臨時特例に関する省令																		
平成二十二年四月以降において発生が確認された口蹄疫に起因して生じた事態に対処するための手当金等についての児童福祉法施行令等の臨時特例に関する政令	平成二十二年四月以降において発生が確認された口蹄疫に起因して生じた事態に対処するための手当金等についての児福法施行令等の臨時特例に関する政令																		
輸出入取引法施行規則	輸取法施行規則																		
人事院規則一〇—一〇（セクシュアル・ハラスメントの防止等）	セクハラ防止等																		
人事院規則一—三九（構造改革特別区域における人事院規則の特例に関する措置）	特区における人事院規則の特例措置及び特定事業																		
刑法	旧刑法																		
刑法施行法　抄	旧刑法施行法　抄																		
多極分散型国土形成促進法施行令	四全総法施行令																		
多極分散型国土形成促進法第十四条の地方公共団体等を定める省令	四全総法第十四条の地方公共団体等を定める省令																		
内閣府設置法第四条第一項第十三号に規定する北方地域の範囲を定める政令	中央省庁等改革関連法第四条第一項第十三号に規定する北方地域の範囲を定める政令																		
内閣府設置法第四条第三項第七号の六の人工衛星等を定める政令	中央省庁等改革関連法第四条第三項第七号の六の人工衛星等を定める政令																		
任意後見契約に関する法律第三条の規定による証書の様式に関する省令	成年後見制度等関連四法第三条の規定による証書の様式に関する省令																		
本邦外出身者に対する不当な差別的言動の解消に向けた取組の推進に関する法律	ヘイトスピーチ解消法																		
人工衛星等の打上げ及び人工衛星の管理に関する法律	宇宙活動法																		
人工衛星等の打上げ及び人工衛星の管理に関する法律施行令	宇宙活動法施行令																		
特定外来生物による生態系等に係る被害の防止に関する法律	外来生物法																		
特定外来生物による生態系等に係る被害の防止に関する法律施行規則	外来生物法施行規則																		
民間資金等の活用による公共施設等の整備等の促進に関する法律施行規則	ＰＦＩ法施行規則																		
中小企業における労働力の確保及び良好な雇用の機会の創出のための雇用管理の改善の促進に関する法律に基づく委託募集に関する省令	中小企業労働力確保法委託募集省令																		
明治三十二年法律第四十号（失火ノ責任ニ関スル法律）	失火責任法	失火法																	
農業振興地域の整備に関する法律	農振法																		
出入国管理及び難民認定法	入管法																		
出入国管理及び難民認定法施行規則	入管法施行規則																		
暴力団員による不当な行為の防止等に関する法律	暴対法	暴力団対策法																	
自動車から排出される窒素酸化物及び粒子状物質の特定地域における総量の削減等に関する特別措置法施行令	自動車ＮＯｘ・ＰＭ法施行令	排ガス抑制法施行令																	
自動車から排出される窒素酸化物及び粒子状物質の特定地域における総量の削減等に関する特別措置法施行規則	排ガス抑制法施行令	自動車ＮＯｘ・ＰＭ法施行令																	
生涯学習の振興のための施策の推進体制等の整備に関する法律	生涯学習振興法																		
生涯学習の振興のための施策の推進体制等の整備に関する法律施行令	生涯学習振興法施行令																		
中小企業における労働力の確保及び良好な雇用の機会の創出のための雇用管理の改善の促進に関する法律施行規則	中小企業労働力確保法施行規則																		
暴力団員による不当な行為の防止等に関する法律施行規則	暴対法施行規則	暴力団対策法施行規則																	
自動車の保管場所の確保等に関する法律施行規則	ガレージ法施行規則	車庫法施行規則																	
暴力団員による不当な行為の防止等に関する法律の規定に基づく意見聴取の実施に関する規則	暴対法意見聴取規則	暴力団対策法意見聴取規則																	
資源の有効な利用の促進に関する法律	リサイクル法																		
大規模小売店舗立地法施行規則	大店立地法施行規則																		
中小企業における労働力の確保及び良好な雇用の機会の創出のための雇用管理の改善の促進に関する法律	中小企業労働力確保法																		
商品投資に係る事業の規制に関する法律	商品ファンド法																		
国会職員の育児休業等に関する法律	国会職員育児休業法																		
国家公務員の育児休業等に関する法律	国家公務員育児休業法																		
地方公務員の育児休業等に関する法律	地方公務員育児休業法																		
裁判官の育児休業に関する法律	裁判官育児休業法																		
中小企業における労働力の確保及び良好な雇用の機会の創出のための雇用管理の改善の促進に関する法律施行令	中小企業労働力確保法施行令																		
資源の有効な利用の促進に関する法律施行令	リサイクル法施行令																		
暴力団員による不当な行為の防止等に関する法律施行令	暴対法施行令	暴力団対策法施行令																	
国際連合平和維持活動等に対する協力に関する法律施行規則	ＰＫＯ協力法施行規則	国連平和協力法施行規則	ＰＫＯ法施行規則																
産業廃棄物の処理に係る特定施設の整備の促進に関する法律施行規則	産業廃棄物法施行規則	産廃法施行規則																	
介護労働者の雇用管理の改善等に関する法律施行規則	介護労働者法施行規則																		
地方拠点都市地域の整備及び産業業務施設の再配置の促進に関する法律第十六条第一項の事業者及び公共施設に準ずる施設を定める省令	地方拠点都市法事業者及び公共施設省令	地方拠点法事業者及び公共施設省令																	
産業廃棄物の処理に係る特定施設の整備の促進に関する法律	産業廃棄物法	産廃法																	
介護労働者の雇用管理の改善等に関する法律	介護労働者法																		
自動車から排出される窒素酸化物及び粒子状物質の特定地域における総量の削減等に関する特別措置法	自動車ＮＯｘ・ＰＭ法	排ガス抑制法																	
絶滅のおそれのある野生動植物の種の保存に関する法律	種の保存法																		
地方拠点都市地域の整備及び産業業務施設の再配置の促進に関する法律	地方拠点都市法	地方拠点法																	
国際連合平和維持活動等に対する協力に関する法律	ＰＫＯ協力法	国連平和協力法	ＰＫＯ法																
政治倫理の確立のための国会議員の資産等の公開等に関する法律	資産公開法																		
国会等の移転に関する法律	国会移転法																		
商品投資に係る事業の規制に関する法律施行令	商品ファンド法施行令																		
介護労働者の雇用管理の改善等に関する法律施行令	介護労働者法施行令																		
地方拠点都市地域の整備及び産業業務施設の再配置の促進に関する法律施行令	地方拠点都市法施行令	地方拠点法施行令																	
国際連合平和維持活動等に対する協力に関する法律施行令	ＰＫＯ協力法施行令	国連平和協力法施行令	ＰＫＯ法施行令																
産業廃棄物の処理に係る特定施設の整備の促進に関する法律施行令	産業廃棄物法施行令	産廃法施行令																	
絶滅のおそれのある野生動植物の種の保存に関する法律施行規則	種の保存法施行規則																		
絶滅のおそれのある野生動植物の種の保存に関する法律第五十二条の規定による負担金の徴収方法等に関する省令	種の保存法負担金徴収方法等省令																		
特定農山村地域における農林業等の活性化のための基盤整備の促進に関する法律施行規則	特定農山村法施行規則																		
金融商品取引法第二条に規定する定義に関する内閣府令	証取法定義に関する内閣府令																		
短時間労働者の雇用管理の改善等に関する法律施行規則	パートタイム法施行規則	パート労働法施行規則																	
地方拠点都市地域の整備及び産業業務施設の再配置の促進に関する法律第十二条及び第三十六条の地方公共団体等を定める省令	地方拠点都市法地方公共団体等省令	地方拠点法地方公共団体等省令																	
特定農山村地域における農林業等の活性化のための基盤整備の促進に関する法律	特定農山村法																		
短時間労働者の雇用管理の改善等に関する法律	パートタイム法	パート労働法																	
絶滅のおそれのある野生動植物の種の保存に関する法律施行令	種の保存法施行令																		
特定農山村地域における農林業等の活性化のための基盤整備の促進に関する法律施行令	特定農山村法施行令																		
国際会議等の誘致の促進及び開催の円滑化等による国際観光の振興に関する法律施行規則	コンベンション法施行規則																		
特定農山村地域における農林業等の活性化のための基盤整備の促進に関する法律第十八条第一項の第七条の認定を受けた者及び農林業等活性化基盤施設を定める省令	特定農山村法認定者及び活性化基盤施設省令																		
道路交通法の規定に基づく意見の聴取及び弁明の機会の付与に関する規則	道交法意見聴取及び弁明機会付与規則																		
一般職の職員の勤務時間、休暇等に関する法律	勤務時間法																		
国際会議等の誘致の促進及び開催の円滑化等による国際観光の振興に関する法律	コンベンション法																		
製造物責任法	ＰＬ法																		
主要食糧の需給及び価格の安定に関する法律	主要食糧需給価格安定法																		
労働基準法第三十七条第一項の時間外及び休日の割増賃金に係る率の最低限度を定める政令	労基法時間外及び休日割増賃金率最低限度政令																		
国の所有に係る日本たばこ産業株式会社の株式の処分に関する政令	ＪＴ株処分政令																		
特定物質の規制等によるオゾン層の保護に関する法律施行令	オゾン層保護法施行令																		
容器包装に係る分別収集及び再商品化の促進等に関する法律施行規則	容器包装リサイクル法施行規則																		
容器包装に係る分別収集及び再商品化の促進等に関する法律第二条第十項第一号に規定する委託の範囲を定める省令	容器包装リサイクル法委託の範囲省令																		
主要食糧の需給及び価格の安定に関する法律施行規則	主要食糧需給価格安定法施行規則																		
化学兵器の禁止及び特定物質の規制等に関する法律施行規則	化学兵器禁止法施行規則																		
特定農山村地域における農林業等の活性化のための基盤整備の促進に関する法律第十六条の地方税の不均一課税に伴う措置が適用される場合等を定める省令	特定農山村法地方税不均一課税適用省令																		
被災区分所有建物の再建等に関する特別措置法	被災マンション法																		
化学兵器の禁止及び特定物質の規制等に関する法律	化学兵器禁止法																		
サリン等による人身被害の防止に関する法律	サリン防止法																		
容器包装に係る分別収集及び再商品化の促進等に関する法律	容器包装リサイクル法																		
被災区分所有建物の再建等に関する特別措置法第二条第一項の災害を定める政令	被災マンション法災害を定める政令																		
主要食糧の需給及び価格の安定に関する法律施行令	主要食糧需給価格安定法施行令																		
化学兵器の禁止及び特定物質の規制等に関する法律施行令	化学兵器禁止法施行令																		
サリン等による人身被害の防止に関する法律の規定による規制等に係る物質を定める政令	サリン防止法規制等物質政令																		
容器包装に係る分別収集及び再商品化の促進等に関する法律施行令	容器包装リサイクル法施行令																		
放射性同位元素等による放射線障害の防止に関する法律第六十二条第二項第一号に規定する担保金の提供等に関する命令	放射線障害防止法担保金の提供等命令																		
自動車損害賠償保障法第二十九条の二第一項に規定する保険会社及び組合の料率団体に対する報告に関する内閣府令	自賠法料率団体報告内閣府令																		
容器包装に係る分別収集及び再商品化の促進等に関する法律第三十五条の規定に基づく市町村長の申出に関する省令	容器包装リサイクル法市町村長の申出省令																		
海洋生物資源の保存及び管理に関する法律施行規則	ＴＡＣ法施行規則																		
木材の安定供給の確保に関する特別措置法施行規則	木材安定供給確保特別措置法施行規則																		
木材の安定供給の確保に関する特別措置法	木材安定供給確保特別措置法																		
海洋生物資源の保存及び管理に関する法律	ＴＡＣ法																		
金融機関等の更生手続の特例等に関する法律	更生特例法																		
覚せい剤原料を指定する政令	覚醒剤原料指定政令																		
木材の安定供給の確保に関する特別措置法施行令	木材安定供給確保特別措置法施行令																		
アイヌ文化の振興並びにアイヌの伝統等に関する知識の普及及び啓発に関する法律施行規則	アイヌ文化振興法施行規則	アイヌ新法施行規則																	
自動車損害賠償保障法第二十八条の三第一項に規定する準備金の積立て等に関する命令	自賠法準備金積立て等命令																		
アイヌ文化の振興並びにアイヌの伝統等に関する知識の普及及び啓発に関する法律附則第三条第二項に規定する北海道旧土人共有財産に係る公告等に関する省令	アイヌ文化振興法省令	アイヌ新法省令																	
廃棄物の処理及び清掃に関する法律施行令の一部を改正する政令附則第二条第三項及び第四項の規定による届出に関する省令	廃棄物処理法施行令届出省令	ごみ処理法施行令届出省令	廃掃法施行令届出省令																
臓器の移植に関する法律施行規則	臓器移植法施行規則																		
工業標準化法に基づく登録試験事業者等に関する省令	ＪＩＳ法認定試験事業者等省令	ジス法認定試験事業者等省令																	
外国人観光旅客の旅行の容易化等の促進による国際観光の振興に関する法律施行規則	外客誘致法施行規則																		
私的独占の禁止及び公正取引の確保に関する法律の適用除外制度の整理等に関する法律第十六条及び第二十条の施行に伴う経過措置を定める省令	独禁法経過措置省令	独占禁止法経過措置省令																	
アイヌ文化の振興並びにアイヌの伝統等に関する知識の普及及び啓発に関する法律	アイヌ文化振興法	アイヌ新法																	
環境影響評価法	環境アセスメント法	環境アセス法																	
外国人観光旅客の旅行の容易化等の促進による国際観光の振興に関する法律	外客誘致法																		
臓器の移植に関する法律	臓器移植法																		
アイヌ文化の振興並びにアイヌの伝統等に関する知識の普及及び啓発に関する法律第六条第一項の都道府県を定める政令	アイヌ文化振興法政令	アイヌ新法政令																	
臓器の移植に関する法律附則第十一条第一項の法律を定める政令	臓器移植法附則法律を定める政令																		
環境影響評価法施行令	環境アセスメント法施行令	環境アセス法施行令																	
環境影響評価法施行規則	環境アセスメント法施行規則	環境アセス法施行規則																	
金融機能の再生のための緊急措置に関する法律第六十条に規定する預金保険機構の業務の特例に係る業務方法書の記載事項に関する命令	金融再生法業務方法書の記載事項命令	金融機能再生法業務方法書の記載事項命令																	
金融機能の早期健全化のための緊急措置に関する法律第十四条に規定する金融機能早期健全化業務に係る業務方法書の記載事項に関する命令	金融早期健全化法業務方法書の記載事項命令	金融機能早期健全化法業務方法書の記載事項命令																	
スポーツ振興投票に係る業務の委託を受けた金融機関の業務の運営に関する命令	サッカーくじ業務委託命令																		
金融機能の早期健全化のための緊急措置に関する法律第二条に規定する定義に関する命令	金融早期健全化法定義命令	金融機能早期健全化法第二条定義命令																	
外国為替及び外国貿易法第六十八条第二項に規定する証票の様式を定める省令	外為法第六十八条第二項に規定する証票の様式を定める省令	外国為替法第六十八条第二項に規定する証票の様式を定める省令	外為法証票様式大蔵省令																
電子計算機を使用して作成する国税関係帳簿書類の保存方法等の特例に関する法律施行規則	電子帳簿保存法施行規則																		
スポーツ振興投票の実施等に関する法律施行規則	サッカーくじ法施行規則																		
感染症の予防及び感染症の患者に対する医療に関する法律施行規則	感染症予防法施行規則																		
食品の製造過程の管理の高度化に関する臨時措置法施行規則	ＨＡＣＣＰ手法支援法施行規則																		
金融機能の再生のための緊急措置に関する法律施行規則	金融再生法施行規則	金融機能再生法施行規則																	
金融機能の早期健全化のための緊急措置に関する法律施行規則	金融早期健全化法	金融機能早期健全化法																	
電子計算機を使用して作成する国税関係帳簿書類の保存方法等の特例に関する法律	電子帳簿保存法																		
土地の再評価に関する法律	土地再評価法																		
家畜排せつ物の管理の適正化及び利用の促進に関する法律	ふん尿法																		
民間資金等の活用による公共施設等の整備等の促進に関する法律	ＰＦＩ推進法	ＰＦＩ法																	
政治倫理の確立のための仮名による株取引等の禁止に関する法律	仮名株取引禁止法																		
国旗及び国歌に関する法律	国旗国歌法	日の丸君が代法	国旗・国歌法																
不正アクセス行為の禁止等に関する法律	不正アクセス禁止法																		
無差別大量殺人行為を行った団体の規制に関する法律	団体規制法	オウム新法																	
債権管理回収業に関する特別措置法施行令	サービサー法施行令																		
労働基準法の一部を改正する法律の施行に伴う年次有給休暇に関する経過措置に関する政令	労基法一部改正法施行に伴う年休経過措置政令																		
地球温暖化対策の推進に関する法律施行令	地球温暖化対策推進法施行令																		
民間資金等の活用による公共施設等の整備等の促進に関する法律施行令	ＰＦＩ推進法施行令	ＰＦＩ法施行令																	
家畜排せつ物の管理の適正化及び利用の促進に関する法律施行令	ふん尿法施行令																		
無差別大量殺人行為を行った団体の規制に関する法律施行令	団体規制法施行令	オウム新法施行令																	
官公庁施設の建設等に関する法律施行規則	官公法委任権限省令																		
ストーカー行為等の規制等に関する法律施行規則	ストーカー規制法施行規則	ストーカー法施行規則																	
ストーカー行為等の規制等に関する法律の規定に基づく意見の聴取の実施に関する規則	ストーカー規制法意見聴取規則	ストーカー法意見聴取規則																	
土砂災害警戒区域等における土砂災害防止対策の推進に関する法律	土砂災害防止法																		
ストーカー行為等の規制等に関する法律	ストーカー規制法	ストーカー法																	
国等による環境物品等の調達の推進等に関する法律	グリーン購入法	環境物品調達推進法																	
金融商品の販売等に関する法律	金融サービス法																		
電子署名及び認証業務に関する法律	電子署名法																		
大学等における技術に関する研究成果の民間事業者への移転の促進に関する法律	大学等技術移転促進法	ＴＬＯ法																	
スポーツ振興投票の実施等に関する法律	サッカーくじ法																		
大規模小売店舗立地法	大店立地法																		
特定家庭用機器再商品化法	家電リサイクル法																		
資産の流動化に関する法律	資産流動化法																		
感染症の予防及び感染症の患者に対する医療に関する法律	感染症予防法	感染症法																	
対人地雷の製造の禁止及び所持の規制等に関する法律	対人地雷禁止法																		
地球温暖化対策の推進に関する法律	地球温暖化対策推進法																		
債権管理回収業に関する特別措置法	サービサー法																		
金融機能の再生のための緊急措置に関する法律	金融再生法	金融機能再生法																	
金融機能の早期健全化のための緊急措置に関する法律	金融早期健全化法	金融機能早期健全化法																	
土地の再評価に関する法律施行令	土地再評価法施行令																		
食品の製造過程の管理の高度化に関する臨時措置法施行令	ＨＡＣＣＰ手法支援法施行令																		
大学等における技術に関する研究成果の民間事業者への移転の促進に関する法律施行令	大学等技術移転促進法施行令	ＴＬＯ法施行令																	
大規模小売店舗立地法施行令	大店立地法施行令																		
金融機能の再生のための緊急措置に関する法律施行令	金融再生法施行令	金融機能再生法施行令																	
金融機能の早期健全化のための緊急措置に関する法律施行令	金融早期健全化法施行令	金融機能早期健全化法施行令																	
スポーツ振興投票の実施等に関する法律施行令	サッカーくじ法施行令																		
特定家庭用機器再商品化法施行令	家電リサイクル法施行令																		
感染症の予防及び感染症の患者に対する医療に関する法律施行令	感染症予防法施行令																		
地球温暖化対策の推進に関する法律施行規則	地球温暖化対策推進法施行規則																		
特定商取引適正化業務を行う者に関する命令	特定商取引適正化業務者命令	訪問販売、通信販売、マルチ販売等適正化業務者命令	訪販、通販、マルチ等適正化業務者命令																
特定商取引に関する法律の規定に基づく立入検査をする職員の携帯する身分を示す証明書の様式を定める命令	特定商取引法立入検査職員身分証明書様式命令	訪問販売、通信販売、マルチ販売等法立入検査職員身分証明書様式命令	訪販、通販、マルチ等法立入検査員身分証明書様式命令																
債権管理回収業に関する特別措置法施行規則	サービサー法施行規則																		
無差別大量殺人行為を行った団体の規制に関する法律施行規則	団体規制法施行規則	オウム新法施行規則																	
感染症の予防及び感染症の患者に対する医療に関する法律第五十四条第一号の輸入禁止地域等を定める省令	感染症予防法輸入禁止地域等省令																		
家畜排せつ物の管理の適正化及び利用の促進に関する法律施行規則	ふん尿法施行規則																		
対人地雷の製造の禁止及び所持の規制等に関する法律施行規則	対人地雷禁止法施行規則																		
労働基準法の一部を改正する法律附則第六条第三項の職業及び日を定める省令	労基法一部改正法附則職業及び日を定める省令																		
住民基本台帳法施行規則	住基法施行規則	住基台帳法施行規則																	
債権管理回収業に関する特別措置法の規定に基づく警察庁長官の意見の陳述等の実施に関する規則	サービサー法警察庁長官意見陳述等規則																		
無差別大量殺人行為を行った団体の規制に関する法律の規定に基づく警察庁長官の意見の陳述等の実施に関する規則	団体規制法警察庁長官意見陳述実施規則	オウム新法警察庁長官意見陳述実施規則																	
無差別大量殺人行為を行った団体の規制に関する法律の規定に基づく規制措置の手続等に関する規則	団体規制法規制措置の手続等規則	オウム新法規制措置の手続等規則																	
行政機関の保有する情報の公開に関する法律	行政機関情報公開法	情報公開法																	
化学物質の審査及び製造等の規制に関する法律の規定に基づく立入検査をする環境省の職員の携帯する身分を示す証明書の様式を定める省令	化審法身分証明書様式省令																		
資産の流動化に関する法律施行規則	資産流動化法施行規則																		
特定商取引に関する法律第六十一条第一項に規定する指定法人を指定する命令	特定商取引法指定法人指定命令	訪問販売、通信販売、マルチ販売等法指定法人指定命令	訪販、通販、マルチ等法指定法人指定命令																
特定家庭用機器再商品化法施行規則	家電リサイクル法施行規則																		
特定商取引に関する法律第六十一条第一項に規定する指定法人が行う同条第二項第四号に規定する特定商取引に関する苦情処理又は相談に係る業務を担当する者を養成する業務に関する命令	特定商取引法指定法人が行う苦情処理省令	訪問販売、通信販売、マルチ販売等法指定法人が行う苦情処理省令	訪販、通販、マルチ等法指定法人が行う苦情処理省令																
建設工事に係る資材の再資源化等に関する法律	建設リサイクル法	建設資材再資源化法																	
食品循環資源の再生利用等の促進に関する法律	食品リサイクル法																		
公職にある者等のあっせん行為による利得等の処罰に関する法律	あっせん利得処罰法																		
高度情報通信ネットワーク社会形成基本法	ＩＴ基本法	ＩＴ法	ＩＴ基本法	ＩＴ法															
ヒトに関するクローン技術等の規制に関する法律	クローン技術規制法	クローン法	ヒトクローン規制法																
マンションの管理の適正化の推進に関する法律	マンション管理適正化法																		
行政機関の保有する情報の公開に関する法律施行令	行政機関情報公開法施行令																		
特定化学物質の環境への排出量の把握等及び管理の改善の促進に関する法律施行令	化管法施行令	化学物質排出把握管理促進法施行令																	
工業標準化法第六十九条第一項の主務大臣等を定める政令	ＪＩＳ法主務大臣等政令	ジス法主務大臣等政令																	
ストーカー行為等の規制等に関する法律施行令	ストーカー規制法施行令	ストーカー法施行令																	
資産の流動化に関する法律施行令	資産流動化法施行令																		
金融商品の販売等に関する法律施行令	金融サービス法施行令																		
建設工事に係る資材の再資源化等に関する法律施行令	建設リサイクル法施行令	建設資材再資源化法施行令																	
郵便貯金法等の一部を改正する法律の施行に伴う経過措置を定める政令	郵貯法等の一部を改正する法律の施行に伴う経過措置を定める政令																		
高度情報通信ネットワーク社会推進戦略本部令	ＩＴ本部令																		
国等による環境物品等の調達の推進等に関する法律第二条第二項の法人を定める政令	グリーン購入法法人政令	環境物品調達推進法法人政令																	
特定化学物質の環境への排出量の把握等及び管理の改善の促進に関する法律施行規則	化管法施行規則	化学物質排出把握管理促進法施行規則																	
電子署名及び認証業務に関する法律に基づく指定調査機関等に関する省令	電子署名法指定調査機関等省令																		
電子署名及び認証業務に関する法律施行規則	電子署名法施行規則																		
行政機関の保有する情報の公開に関する法律等に基づく手数料の納付手続の特例に関する省令	行政機関情報公開法手数料納付手続特例省令																		
エネルギーの使用の合理化に関する法律の規定に基づく立入検査をする職員の携帯する身分を示す証明書の様式を定める省令	省エネ法立入検査職員の身分証明書の様式を定める省令																		
資源の有効な利用の促進に関する法律施行令別表第五の六の項の上欄に規定する特定容器包装に関する省令	リサイクル法施行令特定容器包装省令																		
資源の有効な利用の促進に関する法律の規定に基づく立入検査をする職員の携帯する身分を示す証明書の様式を定める省令	リサイクル法立入検査職員身分証明書様式省令																		
食品循環資源の再生利用等の促進に関する法律に基づく再生利用事業計画の認定に関する省令	食品リサイクル法再生利用事業計画認定省令																		
食品循環資源の再生利用等の促進に関する法律第二十四条第一項及び第三項の規定による立入検査をする職員の携帯する身分を示す証明書の様式を定める省令	食品リサイクル法立入検査職員身分証明書様式省令																		
食品循環資源の再生利用等の促進に関する食品関連事業者の判断の基準となるべき事項を定める省令	食品リサイクル事業者判断基準省令																		
資源の有効な利用の促進に関する法律施行令別表第二の四の項の上欄に規定する複写機に関する省令	リサイクル法施行令複写機省令																		
資源の有効な利用の促進に関する法律施行令別表第三の十五の項の上欄に規定する石油ストーブに関する省令	リサイクル法施行令石油ストーブ省令																		
資源の有効な利用の促進に関する法律施行令別表第五の六の項の中欄第一号に規定する特定容器包装を定める省令	リサイクル法施行令特定容器包装省令																		
資源の有効な利用の促進に関する法律第十二条に規定する計画に関する省令	リサイクル法計画省令																		
エネルギーの使用の合理化等に関する法律に規定する指定試験機関を指定する省令	省エネ法に規定する指定試験機関を指定する省令																		
エネルギーの使用の合理化等に関する法律に規定する指定講習機関を指定する省令	省エネ法に規定する指定講習機関を指定する省令																		
土砂災害警戒区域等における土砂災害防止対策の推進に関する法律施行規則	土砂災害防止法施行規則																		
マンションの管理の適正化の推進に関する法律施行規則	マンション管理適正化法施行規則																		
船員に関する個別労働関係紛争の解決の促進に関する法律施行規則	船員個別労働関係紛争解決促進法施行規則																		
食品循環資源の再生利用等の促進に関する法律第二条第七項の方法を定める省令	食品リサイクル法減量方法省令																		
食品循環資源の再生利用等の促進に関する法律に基づく再生利用事業を行う者の登録に関する省令	食品リサイクル法再生利用事業者登録省令																		
廃棄物の処理及び清掃に関する法律施行令の一部を改正する政令附則第二条第三項の規定による届出に関する省令	廃棄物処理法施行令届出省令	ごみ処理法施行令届出省令	廃掃法施行令届出省令																
ハンセン病療養所入所者等に対する補償金の支給等に関する法律施行規則	ハンセン病等補償法施行規則																		
個別労働関係紛争の解決の促進に関する法律施行規則	個別労働関係紛争解決促進法施行規則																		
配偶者からの暴力の防止及び被害者の保護等に関する法律	配偶者暴力防止法	ＤＶ防止法																	
自動車運転代行業の業務の適正化に関する法律	運転代行業適正化法	自動車運転代行業法																	
フロン類の使用の合理化及び管理の適正化に関する法律	特定製品に係るフロン類の回収及び破壊の実施の確保等に関する法律	フロン排出・抑制法																	
行政機関が行う政策の評価に関する法律	行政機関政策評価法																		
小型船舶の登録等に関する法律	小型船舶登録法																		
個別労働関係紛争の解決の促進に関する法律	個別労働関係紛争解決促進法																		
銀行等の株式等の保有の制限等に関する法律	銀行等株式保有制限法																		
特定電気通信役務提供者の損害賠償責任の制限及び発信者情報の開示に関する法律	プロバイダー責任法	プロバイダー法	ＩＳＰ責任法	プロバイダ責任制限法															
独立行政法人等の保有する情報の公開に関する法律	独立行政法人情報公開法	情報公開法																	
電子署名及び認証業務に関する法律施行令	電子署名法施行令																		
土砂災害警戒区域等における土砂災害防止対策の推進に関する法律施行令	土砂災害防止法施行令																		
食品循環資源の再生利用等の促進に関する法律施行令	食品リサイクル法施行令																		
マンションの管理の適正化の推進に関する法律施行令	マンション管理適正化法施行令																		
行政機関が行う政策の評価に関する法律施行令	行政機関政策評価法施行令																		
旅客鉄道株式会社及び日本貨物鉄道株式会社に関する法律の一部を改正する法律の施行に伴う経過措置を定める政令	ＪＲ会社法経過措置政令																		
フロン類の使用の合理化及び管理の適正化に関する法律施行令	フロン排出・抑制法施行令																		
銀行等の株式等の保有の制限等に関する法律施行令	銀行等株式保有制限法施行令																		
銀行等の株式等の保有の制限に関する内閣府令	銀行等株式保有制限内閣府令																		
特定電子メールの送信の適正化等に関する法律施行規則	迷惑メール対策法施行規則	特定電子メール送信適正化法施行規則																	
食品循環資源の再生利用等の促進に関する法律第二十四条第二項の規定による立入検査をする職員の携帯する身分を示す証明書の様式を定める省令	食品リサイクル法立入検査職員身分証明書様式省令																		
ハンセン病療養所入所者等に対する補償金の支給等に関する法律	ハンセン病等補償法																		
子どもの読書活動の推進に関する法律	子ども読書活動推進法																		
小型船舶の登録等に関する法律の施行に伴う経過措置を定める政令	小型船舶登録法経過措置政令																		
自動車運転代行業の業務の適正化に関する法律の施行に伴う道路交通法施行規則の規定の読替えに関する内閣府令	運転代行業適正化法施行に伴う道交法施行規則の読替え府令	自動車運転代行業法施行に伴う道交法施行規則の読替え府令																	
金融商品取引清算機関等に関する内閣府令	証取積算機関等に関する内閣府令																		
住民基本台帳法別表第一から別表第六までの総務省令で定める事務を定める省令	住基法総務省令で定める事務省令	住基台帳法総務省令で定める事務省令																	
特定電気通信役務提供者の損害賠償責任の制限及び発信者情報の開示に関する法律第四条第一項の発信者情報を定める省令	プロバイダー責任法発信者情報省令	プロバイダー法発信者情報省令	ＩＳＰ責任法発信者情報省令	プロバイダ責任制限法発信者情報省令															
独立行政法人等の保有する情報の公開に関する法律施行令第十三条に規定する情報提供の対象となる法人の範囲を定める省令	独立行政法人情報公開法施行令情報提供の対象となる法人の範囲省令																		
国土交通省関係自動車運転代行業の業務の適正化に関する法律施行規則	国土交通省関係運転代行業適正化法施行規則	国土交通省関係自動車運転代行業法施行規則																	
建設工事に係る資材の再資源化等に関する法律施行規則	建設リサイクル法施行規則	建設資材再資源化法施行規則																	
牛海綿状脳症対策特別措置法施行規則	狂牛病対策特別措置法施行規則	ＢＳＥ対策特別措置法施行規則																	
電子署名及び認証業務に関する法律第十五条第三項に規定する書類の記載事項を定める省令	電子署名法書類の記載事項省令																		
小型自動車競走法施行規則	オートレース法施行規則																		
使用済自動車の再資源化等に関する法律施行規則	自動車リサイクル法施行規則																		
使用済自動車の再資源化等に関する法律施行令第一条第五号の特殊の用途に使用する自動車を定める省令	自動車リサイクル法施行令の特殊の用途に使用する自動車を定める省令																		
小型船舶の登録等に関する法律の施行に伴う経過措置を定める省令	小型船舶登録法経過措置省令																		
鳥獣の保護及び管理並びに狩猟の適正化に関する法律施行規則	鳥獣保護法施行規則																		
厚生労働省関係牛海綿状脳症対策特別措置法施行規則	厚労省関係狂牛病対策特別措置法施行規則	厚労省関係ＢＳＥ対策特別措置法施行規則																	
私的独占の禁止及び公正取引の確保に関する法律第十条第三項に規定する他の国内の会社から除くものとして公正取引委員会規則で定める会社を定める規則	独禁法公正取引委員会規則で定める会社を定める規則	独占禁止法公正取引委員会規則で定める会社を定める規則																	
私的独占の禁止及び公正取引の確保に関する法律第十一条第一項第六号に規定する他の国内の会社の事業活動を拘束するおそれがない場合を定める規則	独禁法他の国内の会社の事業活動を拘束するおそれがない場合を定める規則	独占禁止法他の国内の会社の事業活動を拘束するおそれがない場合を定める規則																	
特定電子メールの送信の適正化等に関する法律	迷惑メール対策法	特定電子メール送信適正化法																	
国家公安委員会関係自動車運転代行業の業務の適正化に関する法律施行規則	国家公安委員会関係運転代行業適正化法施行規則	国家公安委員会関係自動車運転代行業法施行規則																	
貨幣回収準備資金に関する法律	貨幣回収準備資金法																		
公衆等脅迫目的の犯罪行為のための資金等の提供等の処罰に関する法律	テロ資金提供処罰法																		
牛海綿状脳症対策特別措置法	狂牛病対策特別措置法	ＢＳＥ対策特別措置法																	
マンションの建替え等の円滑化に関する法律	マンション建て替え円滑化法																		
文化財の不法な輸出入等の規制等に関する法律	文化財不法輸出入規制法																		
使用済自動車の再資源化等に関する法律	自動車リサイクル法																		
鳥獣の保護及び管理並びに狩猟の適正化に関する法律	鳥獣保護法																		
民間事業者による信書の送達に関する法律	信書便法																		
入札談合等関与行為の排除及び防止並びに職員による入札等の公正を害すべき行為の処罰に関する法律	入札談合防止法	官製談合防止法																	
行政手続等における情報通信の技術の利用に関する法律	行政手続ＩＴ利用法	行政手続オンライン化法																	
金融機関等の組織再編成の促進に関する特別措置法	金融機関組織再編特措法																		
自動車運転代行業の業務の適正化に関する法律施行令	運転代行業適正化法施行令	自動車運転代行業法施行令																	
証券取引法及び金融先物取引法の一部を改正する法律の一部の施行に伴う経過措置に関する政令	証取法等経過措置政令																		
独立行政法人等の保有する情報の公開に関する法律施行令	独立行政法人情報公開法施行令																		
マンションの建替え等の円滑化に関する法律施行令	マンション建て替え円滑化法施行令																		
マンションの建替え等の円滑化に関する法律による不動産登記に関する政令	マンション建て替え円滑化法による不動産登記に関する政令																		
使用済自動車の再資源化等に関する法律施行令	自動車リサイクル法施行令																		
鳥獣の保護及び管理並びに狩猟の適正化に関する法律施行令	鳥獣保護法施行令																		
金融機関等の組織再編成の促進に関する特別措置法施行令	金融機関組織再編特措法施行令																		
内閣府の所管する金融関連法令に係る行政手続等における情報通信の技術の利用に関する法律施行規則	内閣府所管金融関連法令行政手続オンライン化法施行規則	内閣府所管金融関連法令行政手続ＩＴ利用法施行規則																	
内閣総理大臣の所管に属する公益信託の引受けの許可及び監督に関する内閣府令に係る行政手続等における情報通信の技術の利用に関する法律施行規則	内閣総理大臣所管規則及び内閣総理大臣所管総理府令に係る行政手続オンライン化法施行規則	内閣総理大臣所管規則及び内閣総理大臣所管総理府令に係る行政手続ＩＴ利用法施行規則																	
金融機関等の更生手続の特例等に関する法律施行規則	更生特例法施行規則	金融機関更生特例法施行規則																	
民間事業者による信書の送達に関する法律施行規則	信書便法施行規則																		
総務省関係法令に係る行政手続等における情報通信の技術の利用に関する法律施行規則	総務省関係法令行政手続オンライン化法施行規則	総務省関係法令行政手続ＩＴ利用法施行規則																	
法務省の所管する法令の規定に基づく行政手続等における情報通信の技術の利用に関する規則	法務省所管法令行政手続オンライン化法に関する規則	法務省所管法令行政手続ＩＴ利用法に関する規則																	
国税関係法令に係る行政手続等における情報通信の技術の利用に関する省令	国税関係法令行政手続オンライン化法に関する省令	国税関係法令行政手続ＩＴ利用法に関する省令																	
経済産業省の所管する法令に係る行政手続等における情報通信の技術の利用に関する法律施行規則	経済産業省所管法令行政手続オンライン化法施行規則	経済産業省所管法令行政手続ＩＴ利用法施行規則																	
農林水産省の所管する法令に係る行政手続等における情報通信の技術の利用に関する法律施行規則	農林水産省所管法令行政手続オンライン化法施行規則	農林水産省所管法令行政手続ＩＴ利用法施行規則																	
牛の個体識別のための情報の管理及び伝達に関する特別措置法施行規則	牛肉トレーサビリティー法施行規則																		
文部科学省関係の行政手続等における情報通信の技術の利用に関する省令	文部科学省関係行政手続オンライン化法に関する省令	文部科学省関係行政手続ＩＴ利用法に関する省令																	
エネルギーの使用の合理化等に関する法律の規定に基づく立入検査をする職員の携帯する身分を示す証明書の様式を定める省令	省エネ法立入検査職員の身分証明書の様式を定める省令																		
文化財の不法な輸出入等の規制等に関する法律施行規則	文化財不法輸出入規制法施行規則																		
文化財の不法な輸出入等の規制等に関する法律第三条第二項に規定する特定外国文化財を指定する省令	文化財不法輸出入規制法特定外国文化財指定省令																		
個人情報の保護に関する法律	個人情報保護法																		
行政機関の保有する個人情報の保護に関する法律	行政機関個人情報保護法																		
特殊開錠用具の所持の禁止等に関する法律	ピッキング防止法	ピッキング対策法																	
金融機能の強化のための特別措置に関する法律施行令	金融機能強化法施行令																		
預金保険法第五十八条の三第一項に規定する措置に関する内閣府令	預保法に規程する措置に関する内閣府令																		
建物の区分所有等に関する法律施行規則	区分所有法施行規則																		
外務省の所管する法令の規定に基づく行政手続等における情報通信の技術の利用に関する規則	外務省所管法令行政手続オンライン化法に関する規則	外務省所管法令行政手続ＩＴ利用法に関する規則																	
財務省関係の行政手続等における情報通信の技術の利用に関する法律施行規則	財務省関係行政手続オンライン化法施行規則	財務省関係行政手続ＩＴ利用法施行規則																	
遺伝子組換え生物等の使用等の規制による生物の多様性の確保に関する法律施行規則	カルタヘナ議定書担保法施行規則	カルタヘナ担保法施行規則																	
国土交通省の所管する法令に係る行政手続等における情報通信の技術の利用に関する法律施行規則	国土交通省所管法令行政手続オンライン化法施行規則	国土交通省所管法令行政手続ＩＴ利用法施行規則																	
環境省の所管する法令に係る行政手続等における情報通信の技術の利用に関する法律施行規則	環境省所管法令行政手続オンライン化法施行規則	環境省所管法令行政手続ＩＴ利用法施行規則																	
環境省関係構造改革特別区域法第三十四条に規定する政令等規制事業に係る省令の特例に関する措置を定める省令	環境省関係特区法第三十四条に規定する政令等規制事業に係る省令の特例に関する措置を定める省令	環境省関係特区法に規定する特例措置及び特定事業を定める省令																	
厚生労働省の所管する法令に係る行政手続等における情報通信の技術の利用に関する法律施行規則	厚生労働省所管法令行政手続オンライン化法施行規則	厚生労働省所管法令行政手続ＩＴ利用法施行規則																	
公正取引委員会の所管する法令に係る行政手続等における情報通信の技術の利用に関する法律施行規則	公正取引委員会所管法令行政手続オンライン化法施行規則	公正取引委員会所管法令行政手続ＩＴ利用法施行規則																	
行政手続等における情報通信の技術の利用に関する法律の施行に伴う国家公安委員会の所管する関係法令に規定する対象手続等を定める国家公安委員会規則	行政手続オンライン化法施行に伴う国家公安委委員会所管対象手続等を定める国家公安委員会規則	行政手続ＩＴ利用法施行に伴う国家公安委員会所管対象手続等を定める国家公安委員会規則																	
特殊開錠用具の所持の禁止等に関する法律施行規則	ピッキング防止法施行規則	ピッキング対策法施行規則																	
インターネット異性紹介事業を利用して児童を誘引する行為の規制等に関する法律施行規則	出会い系サイト規制法施行規則	出会い系サイト被害防止法施行規則																	
独立行政法人等の保有する個人情報の保護に関する法律	独立行政法人個人情報保護法																		
牛の個体識別のための情報の管理及び伝達に関する特別措置法	牛肉トレーサビリティー法																		
武力攻撃事態等及び存立危機事態における我が国の平和と独立並びに国及び国民の安全の確保に関する法律	武力攻撃事態対処法																		
インターネット異性紹介事業を利用して児童を誘引する行為の規制等に関する法律	出会い系サイト規制法	出会い系サイト被害防止法																	
行政手続等における情報通信の技術の利用に関する法律施行令	行政手続オンライン化法施行令	行政手続ＩＴ利用法施行令																	
民間事業者による信書の送達に関する法律第三十八条の審議会等を定める政令	信書便法の審議会等を定める政令																		
武力攻撃事態等及び存立危機事態における我が国の平和と独立並びに国及び国民の安全の確保に関する法律施行令	武力攻撃事態対処法施行令																		
遺伝子組換え生物等の使用等の規制による生物の多様性の確保に関する法律における主務大臣を定める政令	カルタヘナ議定書担保法主務大臣を定める政令	カルタヘナ担保法主務大臣を定める政令																	
特定産業廃棄物に起因する支障の除去等に関する特別措置法施行令	産廃特措法施行令																		
牛の個体識別のための情報の管理及び伝達に関する特別措置法施行令	牛肉トレーサビリティー法施行令																		
個人情報の保護に関する法律施行令	個人情報保護法施行令																		
化学物質の審査及び製造等の規制に関する法律の一部を改正する法律の施行に伴う経過措置を定める政令	化審法一部改正法施行に伴う経過措置政令																		
行政機関の保有する個人情報の保護に関する法律施行令	行政機関個人情報保護法施行令																		
遺伝子組換え生物等の使用等の規制による生物の多様性の確保に関する法律	カルタヘナ議定書担保法	カルタヘナ担保法																	
特定産業廃棄物に起因する支障の除去等に関する特別措置法	産廃特措法																		
裁判の迅速化に関する法律	裁判迅速化法																		
心神喪失等の状態で重大な他害行為を行った者の医療及び観察等に関する法律	心神喪失者等医療観察法																		
性同一性障害者の性別の取扱いの特例に関する法律	性同一性障害特例法																		
貨幣回収準備資金に関する法律施行令	貨幣回収準備資金法施行令																		
金融機関等の更生手続の特例等に関する法律施行令	更生特例法施行令	金融機関更生特例法施行令																	
特殊開錠用具の所持の禁止等に関する法律施行令	ピッキング防止法施行令	ピッキング対策法施行規則																	
独立行政法人等の保有する個人情報の保護に関する法律施行令	独立行政法人個人情報保護法施行令																		
行政手続等における情報通信の技術の利用に関する法律の施行に伴う行政機関の保有する情報の公開に関する法律に係る対象手続等を定める省令	行政手続ＩＴ利用法の施行に伴う行政機関の保有する情報の公開に関する法律に係る対象手続等を定める省令	行政手続オンライン化法の施行に伴う行政機関の保有する情報の公開に関する法律に係る対象手続等を定める省令																	
行政手続等における情報通信の技術の利用に関する法律の施行に伴う独立行政法人等の保有する情報の公開に関する法律に係る対象手続等を定める省令	行政手続ＩＴ利用法の施行に伴う独立行政法人等の保有する情報の公開に関する法律に係る対象手続等を定める省令	行政手続オンライン化法の施行に伴う独立行政法人等の保有する情報の公開に関する法律に係る対象手続等を定める省令																	
国際航海船舶及び国際港湾施設の保安の確保等に関する法律施行規則	国際船舶・港湾保安法施行規則																		
遺伝子組換え生物等の使用等の規制による生物の多様性の確保に関する法律第三十二条の規定による立入検査等及び報告に関する省令	カルタヘナ議定書担保法立入検査等及び報告に関する省令	カルタヘナ担保法立入検査等及び報告に関する省令																	
風俗営業等の規制及び業務の適正化等に関する法律第二十条第五項に規定する指定試験機関を指定する規則	風営法に規定する指定試験機関を指定する規則																		
国際航海船舶及び国際港湾施設の保安の確保等に関する法律	国際船舶・港湾保安法																		
裁判員の参加する刑事裁判に関する法律	裁判員法																		
環境情報の提供の促進等による特定事業者等の環境に配慮した事業活動の促進に関する法律	環境配慮促進法																		
不動産登記法	新不動産登記法																		
金融機能の強化のための特別措置に関する法律	金融機能強化法																		
民間事業者等が行う書面の保存等における情報通信の技術の利用に関する法律	電子文書法	ｅ−文書法																	
裁判外紛争解決手続の利用の促進に関する法律	ＡＤＲ法																		
遺伝子組換え生物等の使用等の規制による生物の多様性の確保に関する法律第二十四条第一項の規定により納付すべき手数料の額を定める政令	カルタヘナ議定書担保法手数料の額を定める政令	カルタヘナ担保法手数料の額を定める政令																	
住民基本台帳法	住基法	住基台帳法																	
国際航海船舶及び国際港湾施設の保安の確保等に関する法律施行令	国際船舶・港湾保安法施行令																		
流通業務の総合化及び効率化の促進に関する法律	物流総合効率化法																		
民間事業者等が行う書面の保存等における情報通信の技術の利用に関する法律施行令	電子文書法施行令	ｅ−文書法施行令																	
特定外来生物による生態系等に係る被害の防止に関する法律施行令	外来生物法施行令																		
特定特殊自動車排出ガスの規制等に関する法律施行規則	オフロード法施行規則																		
特定特殊自動車排出ガスの規制等に関する法律施行令	オフロード法施行令																		
裁判外紛争解決手続の利用の促進に関する法律施行令	ＡＤＲ法施行令																		
競争の導入による公共サービスの改革に関する法律施行令	公共サービス改革法施行令	市場化テスト法施行令																	
武力攻撃事態等における国民の保護のための措置に関する法律施行令	国民保護法施行令																		
携帯音声通信事業者による契約者等の本人確認等及び携帯音声通信役務の不正な利用の防止に関する法律施行規則	携帯電話不正利用防止法施行規則																		
流通業務の総合化及び効率化の促進に関する法律施行規則	物流総合効率化法施行規則																		
携帯音声通信事業者による契約者等の本人確認等及び携帯音声通信役務の不正な利用の防止に関する法律	携帯電話不正利用防止法																		
特定特殊自動車排出ガスの規制等に関する法律	オフロード法																		
偽造カード等及び盗難カード等を用いて行われる不正な機械式預貯金払戻し等からの預貯金者の保護等に関する法律	預金者保護法																		
流通業務の総合化及び効率化の促進に関する法律施行令	物流総合効率化法施行令																		
裁判外紛争解決手続の利用の促進に関する法律施行規則	ＡＤＲ法施行規則																		
競争の導入による公共サービスの改革に関する法律	公共サービス改革法	市場化テスト法																	
海外の文化遺産の保護に係る国際的な協力の推進に関する法律	文化遺産国際協力推進法																		
有機農業の推進に関する法律	有機農業推進法																		
企業立地の促進等による地域における産業集積の形成及び活性化に関する法律施行規則	企業立地促進法施行規則																		
中小企業による地域産業資源を活用した事業活動の促進に関する法律施行規則	中小企業地域資源活用促進法施行規則																		
農山漁村の活性化のための定住等及び地域間交流の促進に関する法律施行規則	農山漁村活性化法施行規則																		
犯罪による収益の移転防止に関する法律	犯罪収益移転防止法																		
中小企業による地域産業資源を活用した事業活動の促進に関する法律	中小企業地域資源活用促進法																		
地域経済牽引事業の促進による地域の成長発展の基盤強化に関する法律	企業立地促進法																		
農山漁村の活性化のための定住等及び地域間交流の促進に関する法律	農山漁村活性化法																		
国等における温室効果ガス等の排出の削減に配慮した契約の推進に関する法律	環境配慮契約法	グリーン契約法																	
地理空間情報活用推進基本法	ＮＳＤＩ法																		
特定住宅瑕疵担保責任の履行の確保等に関する法律	住宅瑕疵担保履行法																		
犯罪利用預金口座等に係る資金による被害回復分配金の支払等に関する法律	振り込め詐欺救済法																		
鳥獣による農林水産業等に係る被害の防止のための特別措置に関する法律	鳥獣被害防止特措法																		
企業立地の促進等による地域における産業集積の形成及び活性化に関する法律施行令	企業立地促進法施行令																		
中小企業による地域産業資源を活用した事業活動の促進に関する法律施行令	中小企業地域資源活用促進法施行令																		
国等における温室効果ガス等の排出の削減に配慮した契約の推進に関する法律第二条第三項の法人を定める政令	環境配慮契約法政令																		
特定住宅瑕疵担保責任の履行の確保等に関する法律施行令	住宅瑕疵担保履行法施行令																		
地方公共団体の財政の健全化に関する法律施行令	地方自治体財政健全化法施行令	地方公共団体財政健全化法施行令	財政健全化法施行令																
犯罪利用預金口座等に係る資金による被害回復分配金の支払等に関する法律施行規則	振り込め詐欺救済法施行規則																		
犯罪による収益の移転防止に関する法律施行規則	犯罪収益移転防止法施行規則																		
地方公共団体の財政の健全化に関する法律施行規則	財政健全化法施行規則																		
特定住宅瑕疵担保責任の履行の確保等に関する法律施行規則	住宅瑕疵担保履行法施行規則																		
観光圏の整備による観光旅客の来訪及び滞在の促進に関する法律施行規則	観光圏整備法施行規則																		
農林漁業有機物資源のバイオ燃料の原材料としての利用の促進に関する法律施行規則	農林漁業バイオ燃料法施行規則																		
障害のある児童及び生徒のための教科用特定図書等の普及の促進等に関する法律施行規則	教科用特定図書等普及促進法施行規則																		
地域における歴史的風致の維持及び向上に関する法律施行規則	歴史まちづくり法施行規則																		
中小企業者と農林漁業者との連携による事業活動の促進に関する法律	農商工等連携促進法																		
観光圏の整備による観光旅客の来訪及び滞在の促進に関する法律	観光圏整備法																		
地域における歴史的風致の維持及び向上に関する法律	歴史まちづくり法																		
農林漁業有機物資源のバイオ燃料の原材料としての利用の促進に関する法律	農林漁業バイオ燃料法																		
研究開発システムの改革の推進等による研究開発能力の強化及び研究開発等の効率的推進等に関する法律	研究開発力強化法																		
青少年が安全に安心してインターネットを利用できる環境の整備等に関する法律	青少年インターネット環境整備法																		
障害のある児童及び生徒のための教科用特定図書等の普及の促進等に関する法律	教科用特定図書等普及促進法																		
愛がん動物用飼料の安全性の確保に関する法律	ペットフード安全法																		
犯罪による収益の移転防止に関する法律施行令	犯罪収益移転防止法施行令																		
犯罪利用預金口座等に係る資金による被害回復分配金の支払等に関する法律施行令	振り込め詐欺救済法施行令																		
中小企業者と農林漁業者との連携による事業活動の促進に関する法律施行令	農商工等連携促進法施行令																		
障害のある児童及び生徒のための教科用特定図書等の普及の促進等に関する法律施行令	教科用特定図書等普及促進法施行令																		
農林漁業有機物資源のバイオ燃料の原材料としての利用の促進に関する法律施行令	農林漁業バイオ燃料法施行令																		
研究開発システムの改革の推進等による研究開発能力の強化及び研究開発等の効率的推進等に関する法律施行令	研究開発力強化法施行令																		
地域における歴史的風致の維持及び向上に関する法律施行令	歴史まちづくり法施行令																		
愛がん動物用飼料の安全性の確保に関する法律施行令	ペットフード安全法施行令																		
青少年が安全に安心してインターネットを利用できる環境の整備等に関する法律施行令	青少年インターネット環境整備法施行令																		
商店街の活性化のための地域住民の需要に応じた事業活動の促進に関する法律施行規則	地域商店街活性化法施行規則																		
特定地域及び準特定地域における一般乗用旅客自動車運送事業の適正化及び活性化に関する特別措置法施行規則	タクシー適正化・活性化法施行規則																		
愛がん動物用飼料の安全性の確保に関する法律施行規則	ペットフード安全法施行規則																		
米穀等の取引等に係る情報の記録及び産地情報の伝達に関する法律	米トレーサビリティ法																		
厚生年金保険の保険給付及び国民年金の給付の支払の遅延に係る加算金の支給に関する法律	遅延加算金法																		
海賊行為の処罰及び海賊行為への対処に関する法律	海賊対処法																		
資金決済に関する法律	資金決済法																		
特定地域及び準特定地域における一般乗用旅客自動車運送事業の適正化及び活性化に関する特別措置法	タクシー適正化・活性化法																		
公文書等の管理に関する法律	公文書管理法																		
エネルギー供給事業者による非化石エネルギー源の利用及び化石エネルギー原料の有効な利用の促進に関する法律	エネルギー供給構造高度化法																		
商店街の活性化のための地域住民の需要に応じた事業活動の促進に関する法律	地域商店街活性化法																		
美しく豊かな自然を保護するための海岸における良好な景観及び環境の保全に係る海岸漂着物等の処理等の推進に関する法律	海岸漂着物処理推進法																		
商店街の活性化のための地域住民の需要に応じた事業活動の促進に関する法律施行令	地域商店街活性化法施行令																		
エネルギー供給事業者による非化石エネルギー源の利用及び化石エネルギー原料の有効な利用の促進に関する法律施行令	エネルギー供給構造高度化法施行令																		
米穀等の取引等に係る情報の記録及び産地情報の伝達に関する法律施行令	米トレーサビリティ法施行令																		
租税特別措置の適用状況の透明化等に関する法律施行規則	租特透明化法施行規則																		
エネルギー供給事業者による非化石エネルギー源の利用及び化石エネルギー原料の有効な利用の促進に関する法律施行規則	エネルギー供給構造高度化法施行規則																		
租税特別措置の適用状況の透明化等に関する法律	租特透明化法																		
エネルギー環境適合製品の開発及び製造を行う事業の促進に関する法律	低炭素投資促進法																		
地域資源を活用した農林漁業者等による新事業の創出等及び地域の農林水産物の利用促進に関する法律	六次産業化法																		
地域における多様な主体の連携による生物の多様性の保全のための活動の促進等に関する法律	生物多様性地域連携促進法																		
資金決済に関する法律施行令	資金決済法施行令																		
租税特別措置の適用状況の透明化等に関する法律施行令	租特透明化法施行令																		
厚生年金保険の保険給付及び国民年金の給付の支払の遅延に係る加算金の支給に関する法律施行令	遅延加算金法施行令																		
エネルギー環境適合製品の開発及び製造を行う事業の促進に関する法律施行令	低炭素投資促進法施行令																		
公文書等の管理に関する法律施行令	公文書管理法施行令																		
東日本大震災における原子力発電所の事故による災害に対処するための避難住民に係る事務処理の特例及び住所移転者に係る措置に関する法律施行規則	原発避難者特例法施行規則																		
東日本大震災の被災者に係る一般旅券の発給の特例に関する法律施行規則	旅券特例法施行規則																		
地域資源を活用した農林漁業者等による新事業の創出等及び地域の農林水産物の利用促進に関する法律施行規則	六次産業化法施行規則																		
平成二十三年三月十一日に発生した東北地方太平洋沖地震に伴う原子力発電所の事故により放出された放射性物質による環境の汚染への対処に関する特別措置法施行規則	放射性物質汚染対処特措法施行規則																		
海外の美術品等の我が国における公開の促進に関する法律施行規則	海外美術品等公開促進法施行規則																		
海外の美術品等の我が国における公開の促進に関する法律	海外美術品等公開促進法																		
株式会社国際協力銀行法	新ＪＢＩＣ法																		
東日本大震災に対処するための特別の財政援助及び助成に関する法律	東日本大震災財特法																		
職業訓練の実施等による特定求職者の就職の支援に関する法律	求職者支援法																		
東日本大震災の被災者に係る一般旅券の発給の特例に関する法律	旅券特例法																		
東日本大震災における原子力発電所の事故による災害に対処するための避難住民に係る事務処理の特例及び住所移転者に係る措置に関する法律	原発避難者特例法																		
平成二十三年三月十一日に発生した東北地方太平洋沖地震に伴う原子力発電所の事故により放出された放射性物質による環境の汚染への対処に関する特別措置法	放射性物質汚染対処特措法																		
東日本大震災の被災者に係る一般旅券の発給の特例に関する法律施行令	旅券特例法施行令																		
株式会社国際協力銀行法施行令	新ＪＢＩＣ法施行令																		
海外の美術品等の我が国における公開の促進に関する法律施行令	海外美術品等公開促進法施行令																		
平成二十三年三月十一日に発生した東北地方太平洋沖地震に伴う原子力発電所の事故により放出された放射性物質による環境の汚染への対処に関する特別措置法施行令	放射性物質汚染対処特措法施行令																		
行政手続における特定の個人を識別するための番号の利用等に関する法律	マイナンバー法	個人番号法	番号法																
行政手続における特定の個人を識別するための番号の利用等に関する法律施行令	マイナンバー法施行令	個人番号法施行令	番号法施行令																
行政手続における特定の個人を識別するための番号の利用等に関する法律施行規則	マイナンバー法施行規則	番号法施行規則																	
国会に置かれる機関の休日に関する法律	国会休日法																		
裁判所の休日に関する法律	裁判所休日法																		
行政機関の休日に関する法律	行政機関休日法																		
特定物質の規制等によるオゾン層の保護に関する法律	オゾン層保護法																		
特定物質の規制等によるオゾン層の保護に関する法律施行規則	オゾン層保護法施行規則																		
総合保養地域整備法施行令	リゾート法施行令																		
旅客鉄道株式会社及び日本貨物鉄道株式会社に関する法律施行令	ＪＲ会社法施行令																		
外国弁護士による法律事務の取扱いに関する特別措置法関係手数料令	外国弁護士法関係手数料令	外弁法関係手数料令																	
総合保養地域整備法	リゾート法																		
総合保養地域整備法第九条の地方公共団体等を定める省令	リゾート法地方公共団体省令																		
旅客鉄道株式会社及び日本貨物鉄道株式会社に関する法律施行規則	ＪＲ会社法施行規則																		
外国弁護士による法律事務の取扱いに関する特別措置法施行規則	外国弁護士法施行規則	外弁法施行規則																	
労働者派遣事業の適正な運営の確保及び派遣労働者の保護等に関する法律施行令	労働者派遣法施行令	人材派遣法施行令																	
旅客鉄道株式会社及び日本貨物鉄道株式会社に関する法律	ＪＲ会社法																		
外国弁護士による法律事務の取扱いに関する特別措置法	外国弁護士法	外弁法																	
労働者派遣事業の適正な運営の確保及び派遣労働者の保護等に関する法律施行規則	労働者派遣法施行規則	人材派遣法施行規則																	
雇用の分野における男女の均等な機会及び待遇の確保等に関する法律施行規則	男女雇用機会均等法施行規則																		
船員に関する雇用の分野における男女の均等な機会及び待遇の確保等に関する法律施行規則	船員男女雇用機会均等法																		
厚生労働省関係化学物質の審査及び製造等の規制に関する法律施行規則	厚生労働省化審法施行規則																		
日本電信電話株式会社等に関する法律施行令	ＮＴＴ法施行令																		
日本たばこ産業株式会社法施行令	ＪＴ法施行令																		
労働者派遣事業の適正な運営の確保及び派遣労働者の保護等に関する法律	労働者派遣法	人材派遣法																	
風俗営業等の規制及び業務の適正化等に関する法律施行令附則第二項に基づく型式の指定に係る都道府県公安委員会規則の基準を定める規則	風営法施行令型式指定基準規則																		
風俗営業等の規制及び業務の適正化等に関する法律施行規則	風営法施行規則																		
住民基本台帳の一部の写しの閲覧及び住民票の写し等の交付に関する省令	住基台帳閲覧及び交付省令																		
日本電信電話株式会社等に関する法律施行規則	ＮＴＴ法施行規則																		
日本たばこ産業株式会社法施行規則	ＪＴ法施行規則																		
風俗営業等の規制及び業務の適正化等に関する法律に基づく許可申請書の添付書類等に関する内閣府令	風営法認可申請書添付書類内閣府令																		
風俗営業等の規制及び業務の適正化等に関する法律施行令	風営法施行令																		
日本電信電話株式会社等に関する法律	ＮＴＴ法																		
日本たばこ産業株式会社法	ＪＴ法																		
貸金業法施行令	ノンバンク規制法施行令																		
貸金業法	ノンバンク規制法																		
貸金業法施行規則	ノンバンク規制法施行規則																		
農業災害補償法による畑作物共済の共済目的たる農作物を指定する政令	農災法畑作物共済農作物指定政令																		
放射性同位元素等による放射線障害の防止に関する法律第四十三条の二第一項の規定により立入検査を行う職員の携帯する身分を示す証明書の様式を定める省令	放射線障害防止法立入検査職員身分証明書様式省令																		
工業標準化法に基づく認証機関等に関する政令	ＪＩＳ法認定機関及び検査機関政令	ジス法認定機関及び検査機関政令																	
外国為替及び外国貿易法における主務大臣を定める政令	外為法主務大臣政令																		
農業振興地域の整備に関する法律等による不動産登記に関する政令	農振法不動産登記手続政令																		
明日香村における歴史的風土の保存及び生活環境の整備等に関する特別措置法施行令	明日香保存法施行令																		
非化石エネルギーの開発及び導入の促進に関する法律	代エネ法																		
非化石エネルギーの開発及び導入の促進に関する法律第二条第一号の原油等から製造される燃料を定める省令	代エネ法石油製品省令																		
明日香村における歴史的風土の保存及び生活環境の整備等に関する特別措置法	明日香保存法																		
エネルギーの使用の合理化等に関する法律	省エネ法																		
工業標準化法に基づく登録申請手数料の額の計算等に関する省令	ＪＩＳ法外国製造業者等に係る表示認定申請手数料省令	ジス法外国製造業者等に係る表示認定申請手数料省令																	
農業振興地域の整備に関する法律等による不動産登記の手続に関する省令	農振法不動産登記手続省令																		
エネルギーの使用の合理化等に関する法律施行令	省エネ法施行令																		
エネルギーの使用の合理化等に関する法律施行規則	省エネ法施行規則																		
予算決算及び会計令第三十七条に規定する財務大臣の定める日を定める省令	予決令徴収総報告書の送付日省令																		
活動火山対策特別措置法施行令	活火山法施行令																		
無限連鎖講の防止に関する法律	ネズミ講防止法																		
私的独占の禁止及び公正取引の確保に関する法律施行令	独禁法施行令	独占禁止法施行令																	
沖縄県の区域内における位置境界不明地域内の各筆の土地の位置境界の明確化等に関する特別措置法施行令	沖縄位置境界明確化法施行令																		
電子情報処理組織による輸出入等関連業務の処理等に関する法律施行令	ＮＡＣＣＳ特例法施行令																		
領海及び接続水域に関する法律施行令	領海法施行令																		
労働者災害補償保険法施行令	労災法施行令																		
電子情報処理組織による輸出入等関連業務の処理等に関する法律	ＮＡＣＣＳ特例法																		
沖縄県の区域内における位置境界不明地域内の各筆の土地の位置境界の明確化等に関する特別措置法	沖縄位置境界明確化法																		
領海及び接続水域に関する法律	領海法																		
電子情報処理組織による輸出入等関連業務の処理等に関する法律施行規則	ＮＡＣＣＳ特例法施行規則																		
沖縄県の区域内における位置境界不明地域内の各筆の土地の位置境界の明確化等に関する特別措置法施行規則	沖縄位置境界明確化法施行規則																		
特定商取引に関する法律施行令	特定商取引法施行令	訪問販売、通信販売、マルチ販売等法施行令	訪販、通販、マルチ等法施行令																
高年齢者等の雇用の安定等に関する法律施行令	高年齢者雇用安定法施行令																		
船舶の所有者等の責任の制限に関する法律施行令	船主責任制限法施行令																		
飼料の安全性の確保及び品質の改善に関する法律施行令	飼料安全法施行令																		
特定商取引に関する法律	特定商取引法	訪問販売、通信販売、マルチ販売等法	訪販、通販、マルチ等法																
障害者の雇用の促進等に関する法律施行規則	障害者雇用促進法施行規則																		
特定商取引に関する法律施行規則	特定商取引法施行規則	訪問販売、通信販売、マルチ販売等法施行規則	訪販、通販、マルチ等法施行規則																
石油の備蓄の確保等に関する法律施行規則	石油備蓄法施行規則																		
廃棄物の処理及び清掃に関する法律施行令別表第三の三第二十四号に規定する有機塩素化合物を定める省令	廃棄物処理法施行令有機塩素化合物省令	ごみ処理法施行令有機塩素化合物省令	廃掃法施行令有機塩素化合物省令																
廃棄物の処理及び清掃に関する法律施行令第六条第一項第四号に規定する油分を含む産業廃棄物に係る判定基準を定める省令	廃棄物処理法施行令判定基準省令	ごみ処理法施行令判定基準省令	廃掃法施行令判定基準省令																
飼料の安全性の確保及び品質の改善に関する法律施行規則	飼料安全法施行規則																		
動物の愛護及び管理に関する法律施行令	動管法施行令	動物愛護法施行令																	
農業災害補償法による果樹共済の共済目的たる果樹を指定する政令	農災法果樹共済果樹指定政令																		
石油の備蓄の確保等に関する法律	石油備蓄法																		
船舶の所有者等の責任の制限に関する法律	船主責任制限法																		
銃砲刀剣類所持等取締法施行令第二条第二号の銃砲の範囲を定める命令	銃刀法銃砲の範囲命令																		
化学物質の審査及び製造等の規制に関する法律施行令	化審法施行令																		
学校教育の水準の維持向上のための義務教育諸学校の教育職員の人材確保に関する特別措置法	学校教育人材確保法																		
国土交通省関係化学物質の審査及び製造等の規制に関する法律施行規則	国土交通省化審法施行規則																		
覚せい剤取締法施行令	覚醒剤取締法施行令																		
生活関連物資等の買占め及び売惜しみに対する緊急措置に関する法律施行令	買占め防止法施行令																		
化学物質の審査及び製造等の規制に関する法律	化審法																		
動物の愛護及び管理に関する法律	動管法	動物愛護法																	
活動火山対策特別措置法	活火山法																		
生活関連物資等の買占め及び売惜しみに対する緊急措置に関する法律	買占め防止法																		
雇用の分野における男女の均等な機会及び待遇の確保等に関する法律	男女雇用機会均等法																		
船舶に設置する軽水減速加圧軽水冷却型原子炉であつて研究開発段階にあるものの運転計画に関する規則	原子炉等規制法船舶に設置するものの運転計画規則																		
廃棄物の処理及び清掃に関する法律施行令	廃棄物処理法施行令	ごみ処理法施行令	廃掃法施行令																
農用地の土壌の汚染防止等に関する法律施行令	土壌汚染防止法施行令																		
預金保険法施行令	預保法施行令																		
特定工場における公害防止組織の整備に関する法律	公害防止組織整備法																		
高年齢者等の雇用の安定等に関する法律	高年齢者雇用安定法																		
預金保険法	預保法																		
銃砲刀剣類所持等取締法第四条第一項第四号に規定する政令で定める者が行なう推薦の数を定める規則	銃刀法推薦数規則																		
高年齢者等の雇用の安定等に関する法律施行規則	高年齢者雇用安定法施行規則																		
廃棄物の処理及び清掃に関する法律施行規則	廃棄物処理法施行規則	ごみ処理法施行規則	廃掃法施行規則																
建築物における衛生的環境の確保に関する法律施行規則	ビル管理法施行規則																		
預金保険法施行規則	預保法施行規則																		
建築物における衛生的環境の確保に関する法律施行令	ビル管理法施行令																		
人の健康に係る公害犯罪の処罰に関する法律	公害罪法																		
農用地の土壌の汚染防止等に関する法律	土壌汚染防止法																		
廃棄物の処理及び清掃に関する法律	廃棄物処理法	ごみ処理法	廃掃法																
航空機の強取等の処罰に関する法律	ハイジャック防止法																		
建築物における衛生的環境の確保に関する法律	ビル管理法																		
農業振興地域の整備に関する法律施行令	農振法施行令																		
急傾斜地の崩壊による災害の防止に関する法律施行令	がけ崩れ防止法施行令																		
急傾斜地の崩壊による災害の防止に関する法律	がけ崩れ防止法																		
行政機関の職員の定員に関する法律	総定員法																		
急傾斜地の崩壊による災害の防止に関する法律施行規則	がけ崩れ防止法施行規則																		
外国為替及び外国貿易法第六十八条第二項に規定する証票の様式を定める省令	外為法証票様式通産省令																		
農業振興地域の整備に関する法律施行規則	農振法施行規則																		
土砂等を運搬する大型自動車による交通事故の防止等に関する特別措置法施行令	ダンプカー規制法施行令																		
住民基本台帳法施行令	住基法施行令	住基台帳法施行令																	
土砂等を運搬する大型自動車による交通事故の防止等に関する特別措置法	ダンプカー規制法																		
古都における歴史的風土の保存に関する特別措置法施行規則	古都保存法施行規則																		
労働基準法の災害補償に相当する給付に関する法令を指定する省令	労基法災害補償の相当給付に関する法令指定省令																		
土砂等を運搬する大型自動車による交通事故の防止等に関する特別措置法施行規則	ダンプカー規制法施行規則																		
古都における歴史的風土の保存に関する特別措置法施行令	古都保存法施行令																		
官公需についての中小企業者の受注の確保に関する法律施行令	官公需法施行令																		
古都における歴史的風土の保存に関する特別措置法第二条第一項の市町村を定める政令	古都保存法市町村政令																		
地震保険に関する法律施行令	地震保険法施行令																		
官公需についての中小企業者の受注の確保に関する法律	官公需法																		
地震保険に関する法律	地震保険法																		
古都における歴史的風土の保存に関する特別措置法	古都保存法																		
地震保険に関する法律施行規則	地震保険法施行規則																		
金融商品取引法施行令	証取法施行令																		
宅地建物取引業法施行令	宅建業法施行令																		
都市の美観風致を維持するための樹木の保存に関する法律施行令	樹木保存法施行令																		
自動車の保管場所の確保等に関する法律施行令	ガレージ法施行令	車庫法施行令																	
自動車の保管場所の確保等に関する法律	ガレージ法	車庫法																	
銃砲刀剣類登録規則	銃刀登録規則																		
銃砲刀剣類所持等取締法施行規則	銃刀法施行規則																		
宅地建物取引業法施行規則	宅建業法施行規則																		
補助金等に係る予算の執行の適正化に関する法律第二十三条第二項の証票の書式を定める省令	補助金適正化法証票書式省令	補助金等適正化法証票書式省令																	
自動車損害賠償保障事業賦課金等の金額を定める政令	自賠事業賦課金等政令																		
自動車損害賠償保障法施行令	自賠法施行令																		
毒物及び劇物取締法施行令	毒劇物取締法施行令																		
補助金等に係る予算の執行の適正化に関する法律施行令	補助金適正化法施行令	補助金等適正化法施行令																	
補助金等に係る予算の執行の適正化に関する法律	補助金適正化法	補助金等適正化法																	
自動車損害賠償保障法	自賠法																		
労働者災害補償保険法施行規則	労災法施行規則																		
公立学校施設災害復旧費国庫負担法施行規則	学災法施行規則																		
都市の美観風致を維持するための樹木の保存に関する法律	樹木保存法																		
行政事件訴訟法	行訴法																		
不当景品類及び不当表示防止法	景表法	景品表示法																	
建物の区分所有等に関する法律	マンション法	区分所有法																	
都市の美観風致を維持するための樹木の保存に関する法律施行規則	樹木保存法施行規則																		
畜産経営の安定に関する法律施行令	畜産物価格安定法施行令																		
酒に酔つて公衆に迷惑をかける行為の防止等に関する法律	トラ退治法	酔っぱらい防止法																	
畜産物の価格安定に関する法律施行規則	畜産物価格安定法施行規則																		
障害者の雇用の促進等に関する法律施行令	障害者雇用促進法施行令																		
道路交通法施行令	道交法施行令																		
放射性同位元素等による放射線障害の防止に関する法律施行令	放射線障害防止法施行令																		
障害者の雇用の促進等に関する法律	障害者雇用促進法																		
道路交通法	道交法																		
道路交通法施行規則	道交法施行規則																		
放射性同位元素等による放射線障害の防止に関する法律施行規則	放射線障害防止法施行規則																		
銃砲刀剣類所持等取締法施行令	銃刀法施行令																		
銃砲刀剣類所持等取締法	銃刀法																		
放射性同位元素等による放射線障害の防止に関する法律	放射線障害防止法																		
労働基準法第七十六条第二項の規定による常時百人未満の労働者を使用する事業場に使用される労働者に対して行う休業補償の額の改訂及び改訂後の休業補償の額の改訂の方法の特例に関する省令	労基法常時百人未満事業場労働者休業補償額の改訂及び改訂後の休業補償額の改訂方法特例省令																		
国の債権の管理等に関する法律施行令	債権管理法施行令																		
国の債権の管理等に関する法律	債権管理法																		
自動車損害賠償保障事業業務委託契約準則	自賠事業業務委託契約準則																		
自動車損害賠償保障法施行規則	自賠法施行規則																		
公立学校施設災害復旧費国庫負担法施行令	学災法施行令																		
私的独占の禁止及び公正取引の確保に関する法律第四十七条第二項の審査官の指定に関する政令	独禁法審査官指定政令	独占禁止法審査官指定政令																	
小型自動車競走法施行令	オートレース法施行令																		
公立学校施設災害復旧費国庫負担法	学災法																		
飼料の安全性の確保及び品質の改善に関する法律	飼料安全法																		
金融商品取引法第百六十一条の二に規定する取引及びその保証金に関する内閣府令	証取法に規定する取引及びその保証金に関する内閣府令																		
防衛省の職員の給与等に関する法律施行令	防衛庁給与法施行令	防衛庁職員給与法施行令																	
防衛省の職員の給与等に関する法律	防衛庁給与法	防衛庁職員給与法																	
破壊活動防止法	破防法																		
宅地建物取引業法	宅建業法																		
労働基準法第十八条第四項の規定に基づき使用者が労働者の預金を受け入れる場合の利率を定める省令	労基法労働者預金受入利率を定める省令																		
破壊活動防止法施行規則	破防法施行規則																		
農林物資の規格化等に関する法律施行令	ＪＡＳ法施行令	ジャス法施行令																	
覚せい剤取締法	覚醒剤取締法																		
官公庁施設の建設等に関する法律	官公法																		
覚せい剤取締法施行規則	覚醒剤取締法施行規則																		
毒物及び劇物取締法施行規則	毒劇物取締法施行規則																		
火薬類取締法施行令	火取法施行令																		
精神保健及び精神障害者福祉に関する法律施行令	精神保健福祉法施行令																		
公職選挙法施行令	公選法施行令																		
農林物資の規格化等に関する法律	ＪＡＳ法	ジャス法																	
精神保健及び精神障害者福祉に関する法律	精神保健福祉法																		
一般職の職員の給与に関する法律	一般職給与法	一般職職員給与法																	
火薬類取締法施行規則	火取法施行規則																		
精神保健及び精神障害者福祉に関する法律施行規則	精神保健法施行規則																		
外国為替及び外国貿易法における附属の島に関する命令	外為法附属の島命令																		
公職選挙法施行規則	公選法施行規則																		
日本農林規格等に関する法律施行規則	ＪＡＳ法施行規則	ジャス法施行規則																	
工業標準化法に基づく登録申請手数料の額等を定める政令	ＪＩＳ法表示認定申請手数料政令	ジス法表示認定申請手数料政令																	
外国為替及び外国貿易法第五十六条の規定による意見の聴取の手続に関する政令	外為法意見聴取手続政令																		
政府契約の支払遅延防止等に関する法律	支払遅延防止法																		
工業標準化法施行規則	ＪＩＳ法施行規則	ジス法施行規則																	
農業災害補償法による農作物共済の共済目的たる食糧農作物を指定する政令	農災法農作物共済食糧農作物指定政令																		
風俗営業等の規制及び業務の適正化等に関する法律	風営法																		
農業災害補償法第十四条の規定による事務費国庫負担金交付規則	農災法事務費国庫負担金交付規則																		
農業災害補償法施行令	農災法施行令																		
議院における証人の宣誓及び証言等に関する法律	議院証言法																		
国家賠償法	国賠法																		
昭和二十二年法律第五十四号（私的独占の禁止及び公正取引の確保に関する法律）	独禁法	独占禁止法																	
労働者災害補償保険法	労災法																		
労働基準法	労基法																		
労働基準法施行規則	労基法施行規則																		
特定化学物質の環境への排出量の把握等及び管理の改善の促進に関する法律	ＰＲＴＲ法	化学物質把握管理促進法	化管法	化学物質排出把握管理促進法															
防衛省関係法令に係る行政手続等における情報通信の技術の利用に関する法律施行規則	内閣府所管防衛庁関係行政手続オンライン化法施行規則	内閣府所管防衛庁関係行政手続ＩＴ利用法施行規則																	
金融機関の信託業務の兼営等に関する法律	金融機関の信託業務の兼営等に関する法律																		
防衛省の職員の育児休業等に関する政令	防衛省育児休業政令	防衛庁育児休業政令																	
出入国管理及び難民認定法施行令	入管法施行令	入管法地域政令																	
通信・放送融合技術の開発の促進に関する法律	通信・放送融合法																		
育児休業、介護休業等育児又は家族介護を行う労働者の福祉に関する法律	育児・介護休業法																		
船員に関する育児休業、介護休業等育児又は家族介護を行う労働者の福祉に関する法律施行規則	船員育児・介護休業法施行規則																		
中間連結財務諸表の用語、様式及び作成方法に関する規則	中間連結財務諸表規則																		
核原料物質、核燃料物質及び原子炉の規制に関する法律第八十五条第二項第一号に規定する担保金の提供等に関する命令	原子炉等規制法担保金の提供等命令																		
育児休業、介護休業等育児又は家族介護を行う労働者の福祉に関する法律施行規則	育児・介護休業法施行規則																		
児童買春、児童ポルノに係る行為等の規制及び処罰並びに児童の保護等に関する法律	児童買春禁止法																		
国会審議の活性化及び政治主導の政策決定システムの確立に関する法律　抄	国会審議活性化法																		
スポーツ振興投票の対象試合における選手、監督、コーチ及び審判員の登録に関する省令	サッカーくじ対象試合における選手等の登録省令																		
高齢者、障害者等の移動等の円滑化の促進に関する法律第三十九条第一項に規定する土地区画整理事業に関する省令	交通バリアフリー法土地区画整理事業省令																		
社債、株式等の振替に関する法律	社振法	社債等振替法																	
社債、株式等の振替に関する法律施行令	社振法施行令	社債等振替法施行令																	
武力攻撃事態等における国民の保護のための措置に関する法律	国民保護法																		
高齢者、障害者等の移動等の円滑化の促進に関する法律施行規則	バリアフリー法施行規則																		
高齢者、障害者等の移動等の円滑化の促進に関する法律	バリアフリー法																		
高齢者、障害者等の移動等の円滑化の促進に関する法律施行令	バリアフリー法施行令																		
地方公共団体の財政の健全化に関する法律	地方自治体財政健全化法	地方公共団体財政健全化法	財政健全化法																
特定フィブリノゲン製剤及び特定血液凝固第ＩＸ因子製剤によるＣ型肝炎感染被害者を救済するための給付金の支給に関する特別措置法施行規則	特定Ｃ型肝炎ウイルス感染者救済特別措置法施行規則																		
特定フィブリノゲン製剤及び特定血液凝固第ＩＸ因子製剤によるＣ型肝炎感染被害者を救済するための給付金の支給に関する特別措置法	特定Ｃ型肝炎ウイルス感染者救済特別措置法																		
明治五年太政官布告第三百三十七号（改暦ノ布告）	改暦の布告																		
明治八年太政官布告第五十四号（勲章制定ノ件）	勲章制定の件																		
明治八年太政官達第百五十二号（不用物品等払下ノトキ其管庁所属ノ官吏入札禁止ノ件）	不用物品等払下のとき其管庁所属の官吏入札禁止の件																		
明治十年太政官達第九十七号（大勲位菊花大綬章及副章製式ノ件）	大勲位菊花大綬章及副章製式の件																		
明治十九年勅令第五十一号（本初子午線経度計算方及標準時ノ件）	本初子午線経度計算方及標準時の件																		
農業災害補償法施行規則	農災法施行規則																		
農業保険法	農災法																		
墓地、埋葬等に関する法律施行規則	墓地埋葬法施行規則																		
私的独占の禁止及び公正取引の確保に関する法律第九条から第十六条までの規定による認可の申請、報告及び届出等に関する規則	独禁法認可の申請、報告及び届出等規則	独占禁止法認可の申請、報告及び届出等規則																	
出資の受入れ、預り金及び金利等の取締りに関する法律	出資法																		
核原料物質、核燃料物質及び原子炉の規制に関する法律	原子炉等規制法																		
核原料物質、核燃料物質及び原子炉の規制に関する法律施行令	原子炉等規制法施行令																		
財務諸表等の用語、様式及び作成方法に関する規則	財務諸表等規則																		
連結財務諸表の用語、様式及び作成方法に関する規則	連結財務諸表規則																		
中間財務諸表等の用語、様式及び作成方法に関する規則	中間財務諸表等規則																		
核原料物質、核燃料物質及び原子炉の規制に関する法律の規定に基づく立入検査をする職員の携帯する身分を示す証明書の様式を定める省令	原子炉等規制法立入検査職員身分証明書様式省令																		
エネルギーの使用の合理化等に関する法律第八十七条第十一項の規定による立入検査証の様式を定める省令	省エネ法立入検査証の様式を定める省令																		
出入国管理及び難民認定法第七条第一項第二号の基準を定める省令	入管法基準省令																		